protocol	local_address	foreign_address	begin_time	end_time	duration
tcp6	0.0.0.0:31000	0.0.0.0:0	2157	927972	925815
tcp6	192.168.1.100:44558	157.240.205.1:443	2157	119257	117100
tcp6	192.168.1.100:44538	157.240.205.1:443	2157	119257	117100
tcp6	192.168.1.100:37126	13.52.129.247:443	2157	119257	117100
tcp6	192.168.1.100:44492	157.240.205.1:443	2157	6714	4557
tcp6	192.168.1.100:44540	157.240.205.1:443	2157	6714	4557
tcp6	192.168.1.100:42342	54.177.39.110:443	2157	6714	4557
tcp6	192.168.1.100:44560	157.240.205.1:443	2157	6714	4557
tcp6	192.168.1.100:44490	157.240.205.1:443	2157	6714	4557
tcp6	192.168.1.100:44536	157.240.205.1:443	2157	6714	4557
tcp6	192.168.1.100:53878	216.58.209.206:443	2157	6714	4557
tcp6	192.168.1.100:44338	64.233.165.188:5228	2157	6714	4557
tcp6	192.168.1.100:44562	157.240.205.1:443	2157	6714	4557
udp6	0.0.0.0:31000	0.0.0.0:0	2157	936150	933993
tcp6	192.168.1.100:33186	52.232.209.85:443	7811	119257	111446
tcp6	192.168.1.100:44492	157.240.205.1:443	7811	72036	64225
tcp6	192.168.1.100:44540	157.240.205.1:443	7811	72036	64225
tcp6	192.168.1.100:42342	54.177.39.110:443	7811	72036	64225
tcp6	192.168.1.100:44560	157.240.205.1:443	7811	72036	64225
tcp6	192.168.1.100:44490	157.240.205.1:443	7811	72036	64225
tcp6	192.168.1.100:44536	157.240.205.1:443	7811	175333	167522
tcp6	192.168.1.100:53878	216.58.209.206:443	7811	72036	64225
tcp6	192.168.1.100:44338	64.233.165.188:5228	7811	72036	64225
tcp6	192.168.1.100:44562	157.240.205.1:443	7811	72036	64225
tcp6	192.168.1.100:44606	157.240.205.1:443	73197	119257	46060
tcp6	192.168.1.100:44492	157.240.205.1:443	73197	119257	46060
tcp6	192.168.1.100:44540	157.240.205.1:443	73197	175333	102136
tcp6	192.168.1.100:42342	54.177.39.110:443	73197	78945	5748
tcp6	192.168.1.100:44560	157.240.205.1:443	73197	175333	102136
tcp6	192.168.1.100:44490	157.240.205.1:443	73197	135358	62161
tcp6	192.168.1.100:44536	157.240.205.1:443	73197	185794	112597
tcp6	192.168.1.100:44610	157.240.205.1:443	73197	309637	236440
tcp6	192.168.1.100:44608	157.240.205.1:443	73197	302786	229589
tcp6	192.168.1.100:53878	216.58.209.206:443	73197	86870	13673
tcp6	192.168.1.100:44338	64.233.165.188:5228	73197	302786	229589
tcp6	192.168.1.100:44562	157.240.205.1:443	73197	175333	102136
tcp6	192.168.1.100:42404	54.177.39.110:443	80086	283013	202927
tcp6	192.168.1.100:44338	64.233.165.188:5228	88034	283013	194979
tcp6	192.168.1.100:44562	157.240.205.1:443	88034	119257	31223
tcp6	192.168.1.100:50316	184.50.193.58:443	120386	175333	54947
tcp6	192.168.1.100:44558	157.240.205.1:443	120386	175333	54947
tcp6	192.168.1.100:44538	157.240.205.1:443	120386	175333	54947
tcp6	192.168.1.100:37126	13.52.129.247:443	120386	175333	54947
tcp6	192.168.1.100:33186	52.232.209.85:443	120386	266181	145795
tcp6	192.168.1.100:44606	157.240.205.1:443	120386	266181	145795
tcp6	192.168.1.100:44492	157.240.205.1:443	120386	134201	13815
tcp6	192.168.1.100:44540	157.240.205.1:443	120386	188273	67887
tcp6	192.168.1.100:42404	54.177.39.110:443	120386	302786	182400
tcp6	192.168.1.100:44560	157.240.205.1:443	120386	212747	92361
tcp6	192.168.1.100:44490	157.240.205.1:443	120386	134201	13815
tcp6	192.168.1.100:44536	157.240.205.1:443	120386	188273	67887
tcp6	192.168.1.100:44610	157.240.205.1:443	120386	313342	192956
tcp6	192.168.1.100:44608	157.240.205.1:443	120386	309637	189251
tcp6	192.168.1.100:44642	157.240.205.1:443	124948	313342	188394
tcp6	192.168.1.100:44608	157.240.205.1:443	124948	313342	188394
tcp6	192.168.1.100:44640	157.240.205.1:443	124948	313342	188394
tcp6	192.168.1.100:44338	64.233.165.188:5228	124948	313342	188394
tcp6	192.168.1.100:44562	157.240.205.1:443	124948	188273	63325
tcp6	192.168.1.100:44638	157.240.205.1:443	124948	313342	188394
tcp6	192.168.1.100:44642	157.240.205.1:443	135358	309637	174279
tcp6	192.168.1.100:44640	157.240.205.1:443	135358	309637	174279
tcp6	192.168.1.100:44338	64.233.165.188:5228	135358	309637	174279
tcp6	192.168.1.100:44562	157.240.205.1:443	135358	212747	77389
tcp6	192.168.1.100:44638	157.240.205.1:443	135358	309637	174279
tcp6	192.168.1.100:44610	157.240.205.1:443	136496	302786	166290
tcp6	192.168.1.100:44642	157.240.205.1:443	136496	302786	166290
tcp6	192.168.1.100:44640	157.240.205.1:443	136496	302786	166290
tcp6	192.168.1.100:44638	157.240.205.1:443	136496	302786	166290
tcp6	0.0.0.0:30103	0.0.0.0:0	176490	871442	694952
tcp6	0.0.0.0:31000	0.0.0.0:0	176490	871442	694952
tcp6	192.168.1.100:50316	184.50.193.58:443	176490	188273	11783
tcp6	192.168.1.100:44558	157.240.205.1:443	176490	188273	11783
tcp6	192.168.1.100:44538	157.240.205.1:443	176490	188273	11783
tcp6	192.168.1.100:37126	13.52.129.247:443	176490	213939	37449
tcp6	192.168.1.100:33186	52.232.209.85:443	176490	296021	119531
tcp6	192.168.1.100:44606	157.240.205.1:443	176490	296021	119531
tcp6	192.168.1.100:54630	52.85.47.112:443	187011	309637	122626
tcp6	192.168.1.100:34894	35.186.241.51:443	189573	277943	88370
tcp6	192.168.1.100:50316	184.50.193.58:443	189573	190719	1146
tcp6	192.168.1.100:44558	157.240.205.1:443	189573	190719	1146
tcp6	192.168.1.100:44538	157.240.205.1:443	189573	190719	1146
tcp6	192.168.1.100:37126	13.52.129.247:443	189573	212747	23174
tcp6	192.168.1.100:33186	52.232.209.85:443	189573	302786	113213
tcp6	192.168.1.100:44606	157.240.205.1:443	189573	302786	113213
tcp6	192.168.1.100:44540	157.240.205.1:443	189573	190719	1146
tcp6	192.168.1.100:42404	54.177.39.110:443	189573	309637	120064
tcp6	192.168.1.100:44560	157.240.205.1:443	189573	190719	1146
tcp6	192.168.1.100:54630	52.85.47.112:443	189573	313342	123769
tcp6	192.168.1.100:44536	157.240.205.1:443	189573	190719	1146
tcp6	192.168.1.100:44610	157.240.205.1:443	189573	331768	142195
tcp6	192.168.1.100:44642	157.240.205.1:443	189573	409542	219969
tcp6	192.168.1.100:44608	157.240.205.1:443	189573	331768	142195
tcp6	192.168.1.100:44640	157.240.205.1:443	189573	401570	211997
tcp6	192.168.1.100:44338	64.233.165.188:5228	189573	338685	149112
tcp6	192.168.1.100:44562	157.240.205.1:443	189573	190719	1146
tcp6	192.168.1.100:44638	157.240.205.1:443	189573	331768	142195
tcp6	192.168.1.100:45896	52.85.47.122:443	191905	277943	86038
tcp6	192.168.1.100:50316	184.50.193.58:443	191905	277943	86038
tcp6	192.168.1.100:44558	157.240.205.1:443	191905	212747	20842
tcp6	192.168.1.100:44538	157.240.205.1:443	191905	198822	6917
tcp6	192.168.1.100:37126	13.52.129.247:443	191905	198822	6917
tcp6	192.168.1.100:33186	52.232.209.85:443	191905	309637	117732
tcp6	192.168.1.100:44606	157.240.205.1:443	191905	309637	117732
tcp6	192.168.1.100:44540	157.240.205.1:443	191905	198822	6917
tcp6	192.168.1.100:42404	54.177.39.110:443	191905	313342	121437
tcp6	192.168.1.100:44560	157.240.205.1:443	191905	198822	6917
tcp6	192.168.1.100:54630	52.85.47.112:443	191905	331768	139863
tcp6	192.168.1.100:44536	157.240.205.1:443	191905	198822	6917
tcp6	192.168.1.100:44610	157.240.205.1:443	191905	332989	141084
tcp6	192.168.1.100:44642	157.240.205.1:443	191905	420350	228445
tcp6	192.168.1.100:44608	157.240.205.1:443	191905	332989	141084
tcp6	192.168.1.100:44640	157.240.205.1:443	191905	400381	208476
tcp6	192.168.1.100:44338	64.233.165.188:5228	191905	450157	258252
tcp6	192.168.1.100:44562	157.240.205.1:443	191905	198822	6917
tcp6	192.168.1.100:44638	157.240.205.1:443	191905	338685	146780
tcp6	192.168.1.100:54630	52.85.47.112:443	213939	283013	69074
tcp6	192.168.1.100:44610	157.240.205.1:443	213939	283013	69074
tcp6	192.168.1.100:44642	157.240.205.1:443	213939	283013	69074
tcp6	192.168.1.100:44608	157.240.205.1:443	213939	283013	69074
tcp6	192.168.1.100:44640	157.240.205.1:443	213939	283013	69074
tcp6	192.168.1.100:44638	157.240.205.1:443	213939	266181	52242
tcp6	192.168.1.100:42404	54.177.39.110:443	215112	266181	51069
tcp6	192.168.1.100:54630	52.85.47.112:443	215112	266181	51069
tcp6	192.168.1.100:44610	157.240.205.1:443	215112	266181	51069
tcp6	192.168.1.100:44642	157.240.205.1:443	215112	266181	51069
tcp6	192.168.1.100:44608	157.240.205.1:443	215112	266181	51069
tcp6	192.168.1.100:44640	157.240.205.1:443	215112	266181	51069
tcp6	192.168.1.100:44338	64.233.165.188:5228	215112	266181	51069
tcp6	192.168.1.100:44638	157.240.205.1:443	215112	235965	20853
tcp6	192.168.1.100:52888	216.58.209.202:443	237117	266181	29064
tcp6	192.168.1.100:47458	87.250.250.207:443	267388	277943	10555
tcp6	192.168.1.100:52888	216.58.209.202:443	267388	283013	15625
tcp6	192.168.1.100:44638	157.240.205.1:443	267388	283013	15625
tcp6	0.0.0.0:29010	0.0.0.0:0	279224	936150	656926
tcp6	0.0.0.0:30103	0.0.0.0:0	279224	936150	656926
tcp6	0.0.0.0:31000	0.0.0.0:0	279224	936150	656926
tcp6	192.168.1.100:34894	35.186.241.51:443	279224	296021	16797
tcp6	192.168.1.100:45896	52.85.47.122:443	279224	296021	16797
tcp6	192.168.1.100:50316	184.50.193.58:443	279224	296021	16797
tcp6	192.168.1.100:47458	87.250.250.207:443	279224	280429	1205
tcp6	192.168.1.100:54630	52.85.47.112:443	279224	302786	23562
tcp6	192.168.1.100:52888	216.58.209.202:443	279224	302786	23562
tcp6	192.168.1.100:47460	87.250.250.207:443	284327	296021	11694
tcp6	192.168.1.100:41946	87.240.190.70:443	297138	331768	34630
tcp6	192.168.1.100:34894	35.186.241.51:443	297138	331768	34630
tcp6	192.168.1.100:45896	52.85.47.122:443	297138	302786	5648
tcp6	192.168.1.100:50316	184.50.193.58:443	297138	302786	5648
tcp6	192.168.1.100:47460	87.250.250.207:443	297138	297138	0
tcp6	192.168.1.100:52888	216.58.209.202:443	297138	309637	12499
tcp6	192.168.1.100:53110	46.148.238.130:443	303916	353494	49578
tcp6	192.168.1.100:41946	87.240.190.70:443	303916	353494	49578
tcp6	192.168.1.100:34894	35.186.241.51:443	303916	353494	49578
tcp6	192.168.1.100:45896	52.85.47.122:443	303916	331768	27852
tcp6	192.168.1.100:50316	184.50.193.58:443	303916	409542	105626
tcp6	192.168.1.100:44710	157.240.205.1:443	310823	377565	66742
tcp6	192.168.1.100:53110	46.148.238.130:443	310823	409542	98719
tcp6	192.168.1.100:41946	87.240.190.70:443	310823	400381	89558
tcp6	192.168.1.100:34894	35.186.241.51:443	310823	360403	49580
tcp6	192.168.1.100:45896	52.85.47.122:443	310823	353494	42671
tcp6	192.168.1.100:50316	184.50.193.58:443	310823	419209	108386
tcp6	192.168.1.100:44712	157.240.205.1:443	310823	331768	20945
tcp6	192.168.1.100:33186	52.232.209.85:443	310823	532821	221998
tcp6	192.168.1.100:44606	157.240.205.1:443	310823	331768	20945
tcp6	192.168.1.100:42404	54.177.39.110:443	310823	331768	20945
tcp6	192.168.1.100:52888	216.58.209.202:443	310823	331768	20945
tcp6	192.168.1.100:44710	157.240.205.1:443	313342	353494	40152
tcp6	192.168.1.100:44712	157.240.205.1:443	313342	313342	0
tcp6	192.168.1.100:33186	52.232.209.85:443	313342	528156	214814
tcp6	192.168.1.100:44606	157.240.205.1:443	313342	313342	0
tcp6	192.168.1.100:52888	216.58.209.202:443	313342	313342	0
tcp6	192.168.1.100:44710	157.240.205.1:443	331768	331768	0
tcp6	192.168.1.100:53110	46.148.238.130:443	331768	331768	0
tcp6	192.168.1.100:56334	216.58.210.174:443	331768	450157	118389
tcp6	192.168.1.100:41970	87.240.190.70:443	331768	460630	128862
tcp6	192.168.1.100:56334	216.58.210.174:443	332989	460630	127641
tcp6	192.168.1.100:41970	87.240.190.70:443	332989	446692	113703
tcp6	192.168.1.100:50316	184.50.193.58:443	332989	416936	83947
tcp6	192.168.1.100:44712	157.240.205.1:443	332989	377565	44576
tcp6	192.168.1.100:33186	52.232.209.85:443	332989	504175	171186
tcp6	192.168.1.100:44606	157.240.205.1:443	332989	332989	0
tcp6	192.168.1.100:42404	54.177.39.110:443	332989	379880	46891
tcp6	192.168.1.100:54630	52.85.47.112:443	332989	353494	20505
tcp6	192.168.1.100:52888	216.58.209.202:443	332989	450157	117168
tcp6	192.168.1.100:44720	157.240.205.1:443	334098	419209	85111
tcp6	192.168.1.100:44606	157.240.205.1:443	334098	334098	0
tcp6	192.168.1.100:42404	54.177.39.110:443	334098	360403	26305
tcp6	192.168.1.100:54630	52.85.47.112:443	334098	352359	18261
tcp6	192.168.1.100:44610	157.240.205.1:443	334098	334098	0
tcp6	192.168.1.100:44642	157.240.205.1:443	334098	419209	85111
tcp6	192.168.1.100:44718	157.240.205.1:443	334098	409542	75444
tcp6	192.168.1.100:44608	157.240.205.1:443	334098	334098	0
tcp6	192.168.1.100:44640	157.240.205.1:443	334098	420350	86252
tcp6	192.168.1.100:44338	64.233.165.188:5228	334098	872568	538470
tcp6	192.168.1.100:44722	157.240.205.1:443	334098	400381	66283
tcp6	192.168.1.100:52888	216.58.209.202:443	334098	447939	113841
tcp6	192.168.1.100:44638	157.240.205.1:443	334098	400381	66283
tcp6	192.168.1.100:44718	157.240.205.1:443	335301	401570	66269
tcp6	192.168.1.100:44722	157.240.205.1:443	335301	338685	3384
tcp6	192.168.1.100:56334	216.58.210.174:443	339857	446692	106835
tcp6	192.168.1.100:45896	52.85.47.122:443	339857	360403	20546
tcp6	192.168.1.100:41970	87.240.190.70:443	339857	439698	99841
tcp6	192.168.1.100:50316	184.50.193.58:443	339857	360403	20546
tcp6	192.168.1.100:44712	157.240.205.1:443	339857	360403	20546
tcp6	192.168.1.100:33186	52.232.209.85:443	339857	449052	109195
tcp6	192.168.1.100:44720	157.240.205.1:443	339857	416936	77079
tcp6	192.168.1.100:44718	157.240.205.1:443	339857	400381	60524
tcp6	192.168.1.100:44722	157.240.205.1:443	339857	396973	57116
tcp6	192.168.1.100:52888	216.58.209.202:443	339857	462947	123090
tcp6	192.168.1.100:44638	157.240.205.1:443	339857	396973	57116
tcp6	192.168.1.100:53630	77.88.21.207:443	351230	352359	1129
tcp6	192.168.1.100:44640	157.240.205.1:443	351230	409542	58312
tcp6	192.168.1.100:44338	64.233.165.188:5228	351230	913129	561899
tcp6	192.168.1.100:44722	157.240.205.1:443	351230	401570	50340
tcp6	192.168.1.100:52888	216.58.209.202:443	351230	461803	110573
tcp6	192.168.1.100:44638	157.240.205.1:443	351230	401570	50340
tcp6	192.168.1.100:53630	77.88.21.207:443	353494	353494	0
tcp6	192.168.1.100:44728	157.240.205.1:443	354600	440821	86221
tcp6	192.168.1.100:44730	157.240.205.1:443	354600	440821	86221
tcp6	192.168.1.100:54630	52.85.47.112:443	354600	360403	5803
tcp6	192.168.1.100:44642	157.240.205.1:443	354600	416936	62336
tcp6	192.168.1.100:44718	157.240.205.1:443	354600	420350	65750
tcp6	192.168.1.100:53630	77.88.21.207:443	354600	360403	5803
tcp6	192.168.1.100:44640	157.240.205.1:443	354600	419209	64609
tcp6	192.168.1.100:44732	157.240.205.1:443	354600	440821	86221
tcp6	192.168.1.100:44338	64.233.165.188:5228	354600	923364	568764
tcp6	192.168.1.100:44722	157.240.205.1:443	354600	409542	54942
tcp6	192.168.1.100:52888	216.58.209.202:443	354600	472252	117652
tcp6	192.168.1.100:44638	157.240.205.1:443	354600	409542	54942
tcp6	192.168.1.100:44546	178.248.234.116:443	361577	412046	50469
tcp6	192.168.1.100:53110	46.148.238.130:443	361577	416936	55359
tcp6	192.168.1.100:41946	87.240.190.70:443	361577	377565	15988
tcp6	192.168.1.100:34894	35.186.241.51:443	361577	374209	12632
tcp6	192.168.1.100:56334	216.58.210.174:443	361577	439698	78121
tcp6	192.168.1.100:45896	52.85.47.122:443	361577	374209	12632
tcp6	192.168.1.100:41970	87.240.190.70:443	361577	374209	12632
tcp6	192.168.1.100:50316	184.50.193.58:443	361577	374209	12632
tcp6	192.168.1.100:44712	157.240.205.1:443	361577	374209	12632
tcp6	192.168.1.100:33186	52.232.209.85:443	361577	460630	99053
tcp6	192.168.1.100:44720	157.240.205.1:443	361577	426058	64481
tcp6	192.168.1.100:44548	178.248.234.116:443	361577	374209	12632
tcp6	192.168.1.100:60292	92.53.68.203:443	361577	374209	12632
tcp6	192.168.1.100:42404	54.177.39.110:443	361577	374209	12632
tcp6	192.168.1.100:44728	157.240.205.1:443	361577	374209	12632
tcp6	192.168.1.100:44730	157.240.205.1:443	361577	374209	12632
tcp6	192.168.1.100:54630	52.85.47.112:443	361577	374209	12632
tcp6	192.168.1.100:44642	157.240.205.1:443	361577	374209	12632
tcp6	192.168.1.100:44718	157.240.205.1:443	361577	426058	64481
tcp6	192.168.1.100:53630	77.88.21.207:443	361577	367331	5754
tcp6	192.168.1.100:44640	157.240.205.1:443	361577	367331	5754
tcp6	192.168.1.100:44732	157.240.205.1:443	361577	426058	64481
tcp6	192.168.1.100:44338	64.233.165.188:5228	361577	932718	571141
tcp6	192.168.1.100:44722	157.240.205.1:443	361577	419209	57632
tcp6	192.168.1.100:52888	216.58.209.202:443	361577	483608	122031
tcp6	192.168.1.100:44638	157.240.205.1:443	361577	419209	57632
tcp6	192.168.1.100:44640	157.240.205.1:443	368497	374209	5712
tcp6	192.168.1.100:44732	157.240.205.1:443	368497	444356	75859
tcp6	192.168.1.100:44338	64.233.165.188:5228	368497	936150	567653
tcp6	192.168.1.100:44722	157.240.205.1:443	368497	420350	51853
tcp6	192.168.1.100:52888	216.58.209.202:443	368497	481321	112824
tcp6	192.168.1.100:44638	157.240.205.1:443	368497	420350	51853
tcp6	192.168.1.100:44548	178.248.234.116:443	375317	419209	43892
tcp6	192.168.1.100:60292	92.53.68.203:443	375317	377565	2248
tcp6	192.168.1.100:42404	54.177.39.110:443	375317	377565	2248
tcp6	192.168.1.100:44728	157.240.205.1:443	375317	442008	66691
tcp6	192.168.1.100:44730	157.240.205.1:443	375317	442008	66691
tcp6	192.168.1.100:44732	157.240.205.1:443	375317	409542	34225
tcp6	192.168.1.100:44338	64.233.165.188:5228	375317	910702	535385
tcp6	192.168.1.100:44722	157.240.205.1:443	375317	376442	1125
tcp6	192.168.1.100:52888	216.58.209.202:443	375317	464141	88824
tcp6	192.168.1.100:44638	157.240.205.1:443	375317	376442	1125
tcp6	192.168.1.100:39912	216.58.210.142:443	377565	446692	69127
tcp6	192.168.1.100:44642	157.240.205.1:443	377565	377565	0
tcp6	192.168.1.100:44718	157.240.205.1:443	377565	419209	41644
tcp6	192.168.1.100:44546	178.248.234.116:443	378707	419209	40502
tcp6	192.168.1.100:44720	157.240.205.1:443	378707	420350	41643
tcp6	192.168.1.100:44548	178.248.234.116:443	378707	409542	30835
tcp6	192.168.1.100:60292	92.53.68.203:443	378707	381018	2311
tcp6	192.168.1.100:44728	157.240.205.1:443	378707	419209	40502
tcp6	192.168.1.100:44730	157.240.205.1:443	378707	419209	40502
tcp6	192.168.1.100:39912	216.58.210.142:443	378707	462947	84240
tcp6	192.168.1.100:44732	157.240.205.1:443	378707	379880	1173
tcp6	192.168.1.100:44728	157.240.205.1:443	381018	420350	39332
tcp6	192.168.1.100:44730	157.240.205.1:443	381018	420350	39332
tcp6	192.168.1.100:39912	216.58.210.142:443	381018	450157	69139
tcp6	192.168.1.100:44732	157.240.205.1:443	381018	400381	19363
tcp6	192.168.1.100:44728	157.240.205.1:443	382191	409542	27351
tcp6	192.168.1.100:44730	157.240.205.1:443	382191	409542	27351
tcp6	192.168.1.100:39912	216.58.210.142:443	382191	409542	27351
tcp6	192.168.1.100:44732	157.240.205.1:443	382191	401570	19379
tcp6	192.168.1.100:44744	157.240.205.1:443	398080	400381	2301
tcp6	192.168.1.100:44720	157.240.205.1:443	398080	400381	2301
tcp6	192.168.1.100:44548	178.248.234.116:443	398080	420350	22270
tcp6	192.168.1.100:44746	157.240.205.1:443	398080	400381	2301
tcp6	192.168.1.100:44748	157.240.205.1:443	398080	449052	50972
tcp6	192.168.1.100:41970	87.240.190.70:443	401570	450157	48587
tcp6	192.168.1.100:44744	157.240.205.1:443	401570	420350	18780
tcp6	192.168.1.100:44746	157.240.205.1:443	401570	401570	0
tcp6	192.168.1.100:44748	157.240.205.1:443	401570	447939	46369
tcp6	192.168.1.100:38992	104.18.225.52:443	402708	409542	6834
tcp6	192.168.1.100:42540	54.177.39.110:443	402708	409542	6834
tcp6	192.168.1.100:42542	54.177.39.110:443	402708	449052	46344
tcp6	192.168.1.100:44746	157.240.205.1:443	402708	449052	46344
tcp6	192.168.1.100:44748	157.240.205.1:443	402708	442008	39300
tcp6	192.168.1.100:44760	157.240.205.1:443	410749	446692	35943
tcp6	192.168.1.100:44756	157.240.205.1:443	410749	460630	49881
tcp6	192.168.1.100:44758	157.240.205.1:443	410749	444356	33607
tcp6	192.168.1.100:44744	157.240.205.1:443	410749	444356	33607
tcp6	192.168.1.100:44548	178.248.234.116:443	410749	416936	6187
tcp6	192.168.1.100:39912	216.58.210.142:443	410749	440821	30072
tcp6	192.168.1.100:38992	104.18.225.52:443	410749	446692	35943
tcp6	192.168.1.100:42540	54.177.39.110:443	410749	446692	35943
tcp6	192.168.1.100:44718	157.240.205.1:443	410749	416936	6187
tcp6	192.168.1.100:44640	157.240.205.1:443	410749	416936	6187
tcp6	192.168.1.100:42542	54.177.39.110:443	410749	426058	15309
tcp6	192.168.1.100:44746	157.240.205.1:443	410749	444356	33607
tcp6	192.168.1.100:44748	157.240.205.1:443	410749	426058	15309
tcp6	192.168.1.100:44760	157.240.205.1:443	413406	419209	5803
tcp6	192.168.1.100:37332	13.52.129.247:443	413406	446692	33286
tcp6	192.168.1.100:37330	13.52.129.247:443	413406	426058	12652
tcp6	192.168.1.100:44746	157.240.205.1:443	413406	426058	12652
tcp6	192.168.1.100:44338	64.233.165.188:5228	413406	866826	453420
tcp6	192.168.1.100:44722	157.240.205.1:443	413406	426058	12652
tcp6	192.168.1.100:52888	216.58.209.202:443	413406	484720	71314
tcp6	192.168.1.100:44638	157.240.205.1:443	413406	416936	3530
tcp6	192.168.1.100:44748	157.240.205.1:443	413406	416936	3530
tcp6	192.168.1.100:44756	157.240.205.1:443	418080	450157	32077
tcp6	192.168.1.100:44758	157.240.205.1:443	418080	450157	32077
tcp6	192.168.1.100:44744	157.240.205.1:443	418080	449052	30972
tcp6	192.168.1.100:38992	104.18.225.52:443	418080	461803	43723
tcp6	192.168.1.100:42540	54.177.39.110:443	418080	449052	30972
tcp6	192.168.1.100:42542	54.177.39.110:443	418080	444356	26276
tcp6	192.168.1.100:37330	13.52.129.247:443	418080	460630	42550
tcp6	192.168.1.100:44760	157.240.205.1:443	420350	460630	40280
tcp6	192.168.1.100:44546	178.248.234.116:443	420350	420350	0
tcp6	192.168.1.100:37332	13.52.129.247:443	420350	460630	40280
tcp6	192.168.1.100:56334	216.58.210.174:443	420350	630989	210639
tcp6	192.168.1.100:41970	87.240.190.70:443	420350	472252	51902
tcp6	192.168.1.100:44756	157.240.205.1:443	420350	420350	0
tcp6	192.168.1.100:44758	157.240.205.1:443	420350	420350	0
tcp6	192.168.1.100:56800	80.158.2.135:443	420350	488191	67841
tcp6	192.168.1.100:38992	104.18.225.52:443	420350	450157	29807
tcp6	192.168.1.100:42540	54.177.39.110:443	420350	447939	27589
tcp6	192.168.1.100:42542	54.177.39.110:443	420350	446692	26342
tcp6	192.168.1.100:37330	13.52.129.247:443	420350	452630	32280
tcp6	192.168.1.100:44732	157.240.205.1:443	420350	442008	21658
tcp6	192.168.1.100:44746	157.240.205.1:443	420350	442008	21658
tcp6	192.168.1.100:44748	157.240.205.1:443	420350	420350	0
tcp6	0.0.0.0:30102	0.0.0.0:0	421489	439698	18209
tcp6	0.0.0.0:30103	0.0.0.0:0	421489	439698	18209
tcp6	0.0.0.0:31000	0.0.0.0:0	421489	439698	18209
tcp6	192.168.1.100:44760	157.240.205.1:443	421489	439698	18209
tcp6	192.168.1.100:44546	178.248.234.116:443	421489	439698	18209
tcp6	192.168.1.100:37332	13.52.129.247:443	421489	439698	18209
tcp6	192.168.1.100:59876	188.124.39.70:443	421489	439698	18209
tcp6	192.168.1.100:44756	157.240.205.1:443	421489	439698	18209
tcp6	192.168.1.100:44758	157.240.205.1:443	421489	460630	39141
tcp6	192.168.1.100:44744	157.240.205.1:443	421489	446692	25203
tcp6	192.168.1.100:56800	80.158.2.135:443	421489	446692	25203
tcp6	192.168.1.100:44548	178.248.234.116:443	421489	439698	18209
tcp6	192.168.1.100:44728	157.240.205.1:443	421489	444356	22867
tcp6	192.168.1.100:44730	157.240.205.1:443	421489	444356	22867
tcp6	192.168.1.100:39912	216.58.210.142:443	421489	670855	249366
tcp6	192.168.1.100:38992	104.18.225.52:443	421489	444356	22867
tcp6	192.168.1.100:42540	54.177.39.110:443	421489	444356	22867
tcp6	192.168.1.100:47550	87.250.250.207:443	427185	439698	12513
tcp6	192.168.1.100:44748	157.240.205.1:443	427185	444356	17171
tcp6	0.0.0.0:30102	0.0.0.0:0	440821	446692	5871
tcp6	192.168.1.100:59876	188.124.39.70:443	440821	460630	19809
tcp6	192.168.1.100:44778	157.240.205.1:443	440821	449052	8231
tcp6	192.168.1.100:56800	80.158.2.135:443	440821	449052	8231
tcp6	192.168.1.100:44780	157.240.205.1:443	440821	716571	275750
tcp6	192.168.1.100:37330	13.52.129.247:443	440821	449052	8231
tcp6	192.168.1.100:44746	157.240.205.1:443	440821	446692	5871
tcp6	192.168.1.100:44338	64.233.165.188:5228	440821	926803	485982
tcp6	192.168.1.100:44748	157.240.205.1:443	440821	446692	5871
tcp6	192.168.1.100:55838	213.248.110.89:443	442008	444356	2348
tcp6	192.168.1.100:44778	157.240.205.1:443	442008	460630	18622
tcp6	192.168.1.100:56800	80.158.2.135:443	442008	460630	18622
tcp6	192.168.1.100:44780	157.240.205.1:443	442008	717792	275784
tcp6	192.168.1.100:52888	216.58.209.202:443	442008	477911	35903
tcp6	192.168.1.100:41678	87.240.190.78:443	443162	739914	296752
tcp6	192.168.1.100:57274	93.186.225.205:443	445483	725701	280218
tcp6	192.168.1.100:59876	188.124.39.70:443	445483	446692	1209
tcp6	192.168.1.100:44756	157.240.205.1:443	445483	446692	1209
tcp6	192.168.1.100:55838	213.248.110.89:443	445483	460630	15147
tcp6	192.168.1.100:44778	157.240.205.1:443	445483	446692	1209
tcp6	192.168.1.100:33186	52.232.209.85:443	445483	446692	1209
tcp6	192.168.1.100:44780	157.240.205.1:443	445483	504175	58692
tcp6	192.168.1.100:41678	87.240.190.78:443	445483	716571	271088
tcp6	192.168.1.100:37332	13.52.129.247:443	447939	450157	2218
tcp6	192.168.1.100:57274	93.186.225.205:443	447939	715336	267397
tcp6	192.168.1.100:59876	188.124.39.70:443	447939	450157	2218
tcp6	192.168.1.100:55838	213.248.110.89:443	447939	450157	2218
tcp6	192.168.1.100:41678	87.240.190.78:443	447939	748997	301058
tcp6	192.168.1.100:42542	54.177.39.110:443	447939	447939	0
tcp6	192.168.1.100:37330	13.52.129.247:443	447939	447939	0
tcp6	192.168.1.100:44746	157.240.205.1:443	447939	447939	0
tcp6	192.168.1.100:43478	216.58.209.170:443	449052	840588	391536
tcp6	192.168.1.100:44778	157.240.205.1:443	450157	717792	267635
tcp6	192.168.1.100:56800	80.158.2.135:443	450157	504175	54018
tcp6	192.168.1.100:44780	157.240.205.1:443	450157	715336	265179
tcp6	192.168.1.100:41678	87.240.190.78:443	450157	731738	281581
tcp6	192.168.1.100:43478	216.58.209.170:443	450157	817896	367739
tcp6	192.168.1.100:37330	13.52.129.247:443	450157	450157	0
tcp6	192.168.1.100:44794	157.240.205.1:443	451334	716571	265237
tcp6	192.168.1.100:57274	93.186.225.205:443	451334	716571	265237
tcp6	192.168.1.100:44796	157.240.205.1:443	451334	460630	9296
tcp6	192.168.1.100:44804	157.240.205.1:443	451334	725701	274367
tcp6	192.168.1.100:44798	157.240.205.1:443	451334	748997	297663
tcp6	192.168.1.100:43478	216.58.209.170:443	451334	789553	338219
tcp6	192.168.1.100:38992	104.18.225.52:443	451334	452630	1296
tcp6	192.168.1.100:44806	157.240.205.1:443	451334	477911	26577
tcp6	192.168.1.100:44807	157.240.205.1:443	451334	477911	26577
tcp6	192.168.1.100:42610	54.177.39.110:443	453812	714178	260366
tcp6	192.168.1.100:39912	216.58.210.142:443	453812	678754	224942
tcp6	192.168.1.100:43478	216.58.209.170:443	453812	739914	286102
tcp6	192.168.1.100:38992	104.18.225.52:443	453812	460630	6818
tcp6	192.168.1.100:44806	157.240.205.1:443	453812	694841	241029
tcp6	192.168.1.100:44807	157.240.205.1:443	453812	481321	27509
tcp6	192.168.1.100:44794	157.240.205.1:443	461803	528156	66353
tcp6	192.168.1.100:57274	93.186.225.205:443	461803	528156	66353
tcp6	192.168.1.100:59876	188.124.39.70:443	461803	504175	42372
tcp6	192.168.1.100:44796	157.240.205.1:443	461803	734067	272264
tcp6	192.168.1.100:55838	213.248.110.89:443	461803	504175	42372
tcp6	192.168.1.100:44778	157.240.205.1:443	461803	715336	253533
tcp6	192.168.1.100:56800	80.158.2.135:443	461803	484720	22917
tcp6	192.168.1.100:44780	157.240.205.1:443	461803	462947	1144
tcp6	192.168.1.100:41678	87.240.190.78:443	461803	768865	307062
tcp6	192.168.1.100:44804	157.240.205.1:443	461803	462947	1144
tcp6	192.168.1.100:44798	157.240.205.1:443	461803	462947	1144
tcp6	192.168.1.100:42610	54.177.39.110:443	461803	462947	1144
tcp6	192.168.1.100:44806	157.240.205.1:443	461803	461803	0
tcp6	192.168.1.100:44807	157.240.205.1:443	461803	461803	0
tcp6	192.168.1.100:44806	157.240.205.1:443	462947	462947	0
tcp6	192.168.1.100:44807	157.240.205.1:443	462947	462947	0
tcp6	192.168.1.100:44832	157.240.205.1:443	464141	717792	253651
tcp6	192.168.1.100:44834	157.240.205.1:443	464141	717792	253651
tcp6	192.168.1.100:44830	157.240.205.1:443	464141	725701	261560
tcp6	192.168.1.100:44804	157.240.205.1:443	464141	726852	262711
tcp6	192.168.1.100:44798	157.240.205.1:443	464141	731738	267597
tcp6	192.168.1.100:42610	54.177.39.110:443	464141	670855	206714
tcp6	192.168.1.100:44806	157.240.205.1:443	464141	464141	0
tcp6	192.168.1.100:44807	157.240.205.1:443	464141	464141	0
tcp6	192.168.1.100:37398	13.52.129.247:443	465325	725701	260376
tcp6	192.168.1.100:44830	157.240.205.1:443	465325	716571	251246
tcp6	192.168.1.100:44806	157.240.205.1:443	465325	472252	6927
tcp6	192.168.1.100:44807	157.240.205.1:443	465325	472252	6927
tcp6	192.168.1.100:44796	157.240.205.1:443	473379	731738	258359
tcp6	192.168.1.100:44840	157.240.205.1:443	473379	729231	255852
tcp6	192.168.1.100:44838	157.240.205.1:443	473379	748997	275618
tcp6	192.168.1.100:43528	216.58.209.170:443	479013	865694	386681
tcp6	192.168.1.100:57904	13.107.5.88:443	482433	536196	53763
tcp6	192.168.1.100:42610	54.177.39.110:443	482433	715336	232903
tcp6	192.168.1.100:39912	216.58.210.142:443	482433	615135	132702
tcp6	192.168.1.100:43478	216.58.209.170:443	482433	725701	243268
tcp6	192.168.1.100:44838	157.240.205.1:443	482433	739914	257481
tcp6	192.168.1.100:43528	216.58.209.170:443	482433	866826	384393
tcp6	192.168.1.100:44806	157.240.205.1:443	482433	678754	196321
tcp6	192.168.1.100:44807	157.240.205.1:443	482433	694841	212408
tcp6	192.168.1.100:32966	40.70.161.102:443	484720	902746	418026
tcp6	192.168.1.100:43478	216.58.209.170:443	484720	716571	231851
tcp6	192.168.1.100:44838	157.240.205.1:443	484720	716571	231851
tcp6	192.168.1.100:43528	216.58.209.170:443	484720	871442	386722
tcp6	192.168.1.100:44806	157.240.205.1:443	484720	726852	242132
tcp6	192.168.1.100:44807	157.240.205.1:443	484720	678754	194034
tcp6	192.168.1.100:44338	64.233.165.188:5228	484720	882854	398134
tcp6	192.168.1.100:58296	185.40.30.77:443	485828	630989	145161
tcp6	192.168.1.100:44778	157.240.205.1:443	485828	716571	230743
tcp6	192.168.1.100:44832	157.240.205.1:443	485828	488191	2363
tcp6	192.168.1.100:44834	157.240.205.1:443	485828	488191	2363
tcp6	192.168.1.100:37398	13.52.129.247:443	485828	717792	231964
tcp6	192.168.1.100:44830	157.240.205.1:443	485828	717792	231964
tcp6	192.168.1.100:44804	157.240.205.1:443	485828	716571	230743
tcp6	192.168.1.100:44798	157.240.205.1:443	485828	739914	254086
tcp6	192.168.1.100:57904	13.107.5.88:443	485828	611738	125910
tcp6	192.168.1.100:42610	54.177.39.110:443	485828	716571	230743
tcp6	192.168.1.100:39912	216.58.210.142:443	485828	611738	125910
tcp6	192.168.1.100:32966	40.70.161.102:443	485828	901571	415743
tcp6	192.168.1.100:43478	216.58.209.170:443	485828	717792	231964
tcp6	192.168.1.100:44838	157.240.205.1:443	485828	717792	231964
tcp6	192.168.1.100:43528	216.58.209.170:443	485828	789553	303725
tcp6	192.168.1.100:44806	157.240.205.1:443	485828	725701	239873
tcp6	192.168.1.100:44807	157.240.205.1:443	485828	726852	241024
tcp6	192.168.1.100:58294	185.40.30.77:443	485828	611738	125910
tcp6	192.168.1.100:44338	64.233.165.188:5228	485828	901571	415743
tcp6	192.168.1.100:58292	185.40.30.77:443	485828	611738	125910
tcp6	192.168.1.100:52888	216.58.209.202:443	485828	536196	50368
tcp6	192.168.1.100:54634	20.190.160.130:443	488191	609445	121254
tcp6	192.168.1.100:42610	54.177.39.110:443	488191	609445	121254
tcp6	192.168.1.100:39912	216.58.210.142:443	488191	609445	121254
tcp6	192.168.1.100:32966	40.70.161.102:443	488191	900353	412162
tcp6	192.168.1.100:43478	216.58.209.170:443	488191	609445	121254
tcp6	192.168.1.100:44838	157.240.205.1:443	488191	609445	121254
tcp6	192.168.1.100:43528	216.58.209.170:443	488191	739914	251723
tcp6	192.168.1.100:44806	157.240.205.1:443	488191	716571	228380
tcp6	192.168.1.100:44807	157.240.205.1:443	488191	725701	237510
tcp6	192.168.1.100:58294	185.40.30.77:443	488191	609445	121254
tcp6	192.168.1.100:44338	64.233.165.188:5228	488191	900353	412162
tcp6	192.168.1.100:58292	185.40.30.77:443	488191	609445	121254
tcp6	192.168.1.100:52888	216.58.209.202:443	488191	532821	44630
tcp6	192.168.1.100:52872	51.105.218.222:443	489350	615135	125785
tcp6	192.168.1.100:58296	185.40.30.77:443	489350	615135	125785
tcp6	192.168.1.100:44832	157.240.205.1:443	489350	504175	14825
tcp6	192.168.1.100:44834	157.240.205.1:443	489350	504175	14825
tcp6	192.168.1.100:37398	13.52.129.247:443	489350	504175	14825
tcp6	192.168.1.100:44830	157.240.205.1:443	489350	504175	14825
tcp6	192.168.1.100:41678	87.240.190.78:443	489350	717792	228442
tcp6	192.168.1.100:44804	157.240.205.1:443	489350	717792	228442
tcp6	192.168.1.100:44798	157.240.205.1:443	489350	725701	236351
tcp6	192.168.1.100:57904	13.107.5.88:443	489350	504175	14825
tcp6	192.168.1.100:54634	20.190.160.130:443	489350	504175	14825
tcp6	192.168.1.100:42610	54.177.39.110:443	489350	504175	14825
tcp6	192.168.1.100:39912	216.58.210.142:443	489350	504175	14825
tcp6	192.168.1.100:32966	40.70.161.102:443	489350	890996	401646
tcp6	192.168.1.100:43478	216.58.209.170:443	489350	504175	14825
tcp6	192.168.1.100:44838	157.240.205.1:443	489350	504175	14825
tcp6	192.168.1.100:43528	216.58.209.170:443	489350	717792	228442
tcp6	192.168.1.100:44806	157.240.205.1:443	489350	717792	228442
tcp6	192.168.1.100:44807	157.240.205.1:443	489350	716571	227221
tcp6	192.168.1.100:58294	185.40.30.77:443	489350	504175	14825
tcp6	192.168.1.100:44338	64.233.165.188:5228	489350	717792	228442
tcp6	192.168.1.100:58292	185.40.30.77:443	489350	504175	14825
tcp6	192.168.1.100:52888	216.58.209.202:443	489350	504175	14825
tcp6	192.168.1.100:56334	216.58.210.174:443	505334	528156	22822
tcp6	192.168.1.100:44796	157.240.205.1:443	505334	715336	210002
tcp6	192.168.1.100:44840	157.240.205.1:443	505334	715336	210002
tcp6	192.168.1.100:55838	213.248.110.89:443	505334	516824	11490
tcp6	192.168.1.100:52872	51.105.218.222:443	505334	536196	30862
tcp6	192.168.1.100:54634	20.190.160.130:443	505334	536196	30862
tcp6	192.168.1.100:52872	51.105.218.222:443	517965	528156	10191
tcp6	192.168.1.100:58296	185.40.30.77:443	517965	694841	176876
tcp6	192.168.1.100:44832	157.240.205.1:443	517965	725701	207736
tcp6	192.168.1.100:44834	157.240.205.1:443	517965	725701	207736
tcp6	192.168.1.100:37398	13.52.129.247:443	517965	726852	208887
tcp6	192.168.1.100:57904	13.107.5.88:443	517965	528156	10191
tcp6	192.168.1.100:54634	20.190.160.130:443	517965	528156	10191
tcp6	192.168.1.100:58294	185.40.30.77:443	517965	678754	160789
tcp6	192.168.1.100:44338	64.233.165.188:5228	517965	902746	384781
tcp6	192.168.1.100:58292	185.40.30.77:443	517965	678754	160789
tcp6	192.168.1.100:52888	216.58.209.202:443	517965	528156	10191
tcp6	192.168.1.100:54424	52.85.47.9:443	529375	789553	260178
tcp6	192.168.1.100:44450	130.211.34.183:443	531695	716571	184876
tcp6	192.168.1.100:44450	130.211.34.183:443	533946	739914	205968
tcp6	192.168.1.100:37006	52.85.47.45:443	537342	787325	249983
tcp6	192.168.1.100:32966	40.70.161.102:443	616298	725701	109403
tcp6	192.168.1.100:58294	185.40.30.77:443	616298	694841	78543
tcp6	192.168.1.100:58292	185.40.30.77:443	616298	694841	78543
tcp6	192.168.1.100:37006	52.85.47.45:443	632101	789553	157452
tcp6	192.168.1.100:44832	157.240.205.1:443	632101	726852	94751
tcp6	192.168.1.100:44834	157.240.205.1:443	632101	726852	94751
tcp6	192.168.1.100:37398	13.52.129.247:443	632101	670855	38754
tcp6	192.168.1.100:44780	157.240.205.1:443	632101	670855	38754
tcp6	192.168.1.100:44830	157.240.205.1:443	632101	726852	94751
tcp6	192.168.1.100:44450	130.211.34.183:443	632101	787325	155224
tcp6	192.168.1.100:32966	40.70.161.102:443	632101	904999	272898
tcp6	192.168.1.100:35336	103.136.220.205:443	632101	932718	300617
tcp6	192.168.1.100:53776	77.88.21.207:443	671981	726852	54871
tcp6	192.168.1.100:35336	103.136.220.205:443	671981	882854	210873
tcp6	192.168.1.100:58318	185.40.30.77:443	695949	803267	107318
tcp6	192.168.1.100:58316	185.40.30.77:443	695949	789553	93604
tcp6	192.168.1.100:58320	185.40.30.77:443	695949	789553	93604
tcp6	192.168.1.100:35336	103.136.220.205:443	695949	885171	189222
tcp6	192.168.1.100:43566	216.58.209.170:443	715336	882854	167518
tcp6	192.168.1.100:58316	185.40.30.77:443	715336	739914	24578
tcp6	192.168.1.100:58320	185.40.30.77:443	715336	739914	24578
tcp6	192.168.1.100:35336	103.136.220.205:443	715336	902746	187410
tcp6	192.168.1.100:48560	142.250.147.92:443	716571	812253	95682
tcp6	192.168.1.100:58318	185.40.30.77:443	716571	810048	93477
tcp6	192.168.1.100:53776	77.88.21.207:443	716571	731738	15167
tcp6	192.168.1.100:43566	216.58.209.170:443	716571	902746	186175
tcp6	192.168.1.100:58316	185.40.30.77:443	716571	716571	0
tcp6	192.168.1.100:58320	185.40.30.77:443	716571	716571	0
tcp6	192.168.1.100:35336	103.136.220.205:443	716571	901571	185000
tcp6	192.168.1.100:54424	52.85.47.9:443	717792	768865	51073
tcp6	192.168.1.100:44794	157.240.205.1:443	717792	748997	31205
tcp6	192.168.1.100:48560	142.250.147.92:443	717792	787325	69533
tcp6	192.168.1.100:44840	157.240.205.1:443	717792	750151	32359
tcp6	192.168.1.100:37006	52.85.47.45:443	717792	750151	32359
tcp6	192.168.1.100:58318	185.40.30.77:443	717792	789553	71761
tcp6	192.168.1.100:53776	77.88.21.207:443	717792	734067	16275
tcp6	192.168.1.100:44450	130.211.34.183:443	717792	717792	0
tcp6	192.168.1.100:43566	216.58.209.170:443	717792	901571	183779
tcp6	192.168.1.100:42674	54.177.39.110:443	717792	717792	0
tcp6	192.168.1.100:44798	157.240.205.1:443	717792	717792	0
tcp6	192.168.1.100:58316	185.40.30.77:443	717792	717792	0
tcp6	192.168.1.100:58320	185.40.30.77:443	717792	717792	0
tcp6	192.168.1.100:35336	103.136.220.205:443	717792	900353	182561
tcp6	192.168.1.100:44807	157.240.205.1:443	717792	717792	0
tcp6	192.168.1.100:42674	54.177.39.110:443	718939	725701	6762
tcp6	192.168.1.100:43566	216.58.209.170:443	726852	904999	178147
tcp6	192.168.1.100:42674	54.177.39.110:443	726852	726852	0
tcp6	192.168.1.100:53776	77.88.21.207:443	727993	729231	1238
tcp6	192.168.1.100:44450	130.211.34.183:443	727993	783757	55764
tcp6	192.168.1.100:41678	87.240.190.78:443	727993	778081	50088
tcp6	192.168.1.100:43566	216.58.209.170:443	727993	846327	118334
tcp6	192.168.1.100:44798	157.240.205.1:443	727993	729231	1238
tcp6	192.168.1.100:32966	40.70.161.102:443	727993	846327	118334
tcp6	192.168.1.100:43478	216.58.209.170:443	727993	778081	50088
tcp6	192.168.1.100:44838	157.240.205.1:443	727993	729231	1238
tcp6	192.168.1.100:58316	185.40.30.77:443	727993	778081	50088
tcp6	192.168.1.100:58320	185.40.30.77:443	727993	778081	50088
tcp6	192.168.1.100:43528	216.58.209.170:443	727993	848667	120674
tcp6	192.168.1.100:35336	103.136.220.205:443	727993	848667	120674
tcp6	192.168.1.100:44896	157.240.205.1:443	730514	787325	56811
tcp6	192.168.1.100:44898	157.240.205.1:443	730514	750151	19637
tcp6	192.168.1.100:44900	157.240.205.1:443	730514	750151	19637
tcp6	192.168.1.100:58318	185.40.30.77:443	730514	750151	19637
tcp6	192.168.1.100:44450	130.211.34.183:443	730514	789553	59039
tcp6	192.168.1.100:44902	157.240.205.1:443	730514	787325	56811
tcp6	192.168.1.100:43566	216.58.209.170:443	730514	936150	205636
tcp6	192.168.1.100:32966	40.70.161.102:443	730514	936150	205636
tcp6	192.168.1.100:43478	216.58.209.170:443	730514	830294	99780
tcp6	192.168.1.100:44838	157.240.205.1:443	730514	730514	0
tcp6	192.168.1.100:58316	185.40.30.77:443	730514	810048	79534
tcp6	192.168.1.100:58320	185.40.30.77:443	730514	810048	79534
tcp6	192.168.1.100:44904	157.240.205.1:443	730514	810048	79534
tcp6	192.168.1.100:44894	157.240.205.1:443	730514	810048	79534
tcp6	192.168.1.100:38788	216.58.210.131:443	731738	877164	145426
tcp6	192.168.1.100:44838	157.240.205.1:443	731738	731738	0
tcp6	192.168.1.100:58316	185.40.30.77:443	731738	788427	56689
tcp6	192.168.1.100:58320	185.40.30.77:443	731738	788427	56689
tcp6	192.168.1.100:44904	157.240.205.1:443	731738	788427	56689
tcp6	192.168.1.100:44894	157.240.205.1:443	731738	788427	56689
tcp6	192.168.1.100:42698	54.177.39.110:443	731738	788427	56689
tcp6	192.168.1.100:37472	13.52.129.247:443	732895	748997	16102
tcp6	192.168.1.100:48560	142.250.147.92:443	732895	748997	16102
tcp6	192.168.1.100:44896	157.240.205.1:443	732895	734067	1172
tcp6	192.168.1.100:44840	157.240.205.1:443	732895	734067	1172
tcp6	192.168.1.100:37006	52.85.47.45:443	732895	734067	1172
tcp6	192.168.1.100:44898	157.240.205.1:443	732895	734067	1172
tcp6	192.168.1.100:44900	157.240.205.1:443	732895	734067	1172
tcp6	192.168.1.100:58318	185.40.30.77:443	732895	734067	1172
tcp6	192.168.1.100:44902	157.240.205.1:443	732895	748997	16102
tcp6	192.168.1.100:32966	40.70.161.102:443	732895	909481	176586
tcp6	192.168.1.100:38788	216.58.210.131:443	732895	864596	131701
tcp6	192.168.1.100:44904	157.240.205.1:443	732895	789553	56658
tcp6	192.168.1.100:44894	157.240.205.1:443	732895	789553	56658
tcp6	192.168.1.100:42698	54.177.39.110:443	732895	789553	56658
tcp6	192.168.1.100:43290	216.58.210.170:443	735303	896904	161601
tcp6	192.168.1.100:44796	157.240.205.1:443	735303	748997	13694
tcp6	192.168.1.100:44896	157.240.205.1:443	735303	748997	13694
tcp6	192.168.1.100:44840	157.240.205.1:443	735303	748997	13694
tcp6	192.168.1.100:37006	52.85.47.45:443	735303	748997	13694
tcp6	192.168.1.100:44898	157.240.205.1:443	735303	748997	13694
tcp6	192.168.1.100:44900	157.240.205.1:443	735303	748997	13694
tcp6	192.168.1.100:58318	185.40.30.77:443	735303	748997	13694
tcp6	192.168.1.100:53776	77.88.21.207:443	735303	739914	4611
tcp6	192.168.1.100:44902	157.240.205.1:443	735303	739914	4611
tcp6	192.168.1.100:38788	216.58.210.131:443	735303	865694	130391
tcp6	192.168.1.100:44904	157.240.205.1:443	735303	739914	4611
tcp6	192.168.1.100:44894	157.240.205.1:443	735303	739914	4611
tcp6	192.168.1.100:42698	54.177.39.110:443	735303	739914	4611
tcp6	192.168.1.100:37472	13.52.129.247:443	750151	768865	18714
tcp6	192.168.1.100:43290	216.58.210.170:443	750151	936150	185999
tcp6	192.168.1.100:44450	130.211.34.183:443	750151	784947	34796
tcp6	192.168.1.100:41678	87.240.190.78:443	750151	750151	0
tcp6	192.168.1.100:44902	157.240.205.1:443	750151	789553	39402
tcp6	192.168.1.100:43566	216.58.209.170:443	750151	927972	177821
tcp6	192.168.1.100:32966	40.70.161.102:443	750151	926803	176652
tcp6	192.168.1.100:38788	216.58.210.131:443	750151	848667	98516
tcp6	192.168.1.100:44838	157.240.205.1:443	750151	750151	0
tcp6	192.168.1.100:58316	185.40.30.77:443	750151	803267	53116
tcp6	192.168.1.100:58320	185.40.30.77:443	750151	803267	53116
tcp6	192.168.1.100:44904	157.240.205.1:443	750151	832550	82399
tcp6	192.168.1.100:35336	103.136.220.205:443	750151	927972	177821
tcp6	192.168.1.100:44894	157.240.205.1:443	750151	830294	80143
tcp6	192.168.1.100:42698	54.177.39.110:443	750151	830294	80143
tcp6	192.168.1.100:44898	157.240.205.1:443	751311	787325	36014
tcp6	192.168.1.100:44900	157.240.205.1:443	751311	787325	36014
tcp6	192.168.1.100:58318	185.40.30.77:443	751311	787325	36014
tcp6	192.168.1.100:44450	130.211.34.183:443	751311	768865	17554
tcp6	192.168.1.100:44902	157.240.205.1:443	751311	784947	33636
tcp6	192.168.1.100:43566	216.58.209.170:443	751311	926803	175492
tcp6	192.168.1.100:32966	40.70.161.102:443	751311	913129	161818
tcp6	192.168.1.100:38788	216.58.210.131:443	751311	846327	95016
tcp6	192.168.1.100:58316	185.40.30.77:443	751311	768865	17554
tcp6	192.168.1.100:58320	185.40.30.77:443	751311	768865	17554
tcp6	192.168.1.100:44904	157.240.205.1:443	751311	831422	80111
tcp6	192.168.1.100:43528	216.58.209.170:443	751311	873666	122355
tcp6	192.168.1.100:35336	103.136.220.205:443	751311	923364	172053
tcp6	192.168.1.100:44894	157.240.205.1:443	751311	812253	60942
tcp6	192.168.1.100:42698	54.177.39.110:443	751311	812253	60942
tcp6	192.168.1.100:37472	13.52.129.247:443	770003	831422	61419
tcp6	192.168.1.100:43290	216.58.210.170:443	770003	927972	157969
tcp6	192.168.1.100:44896	157.240.205.1:443	770003	812253	42250
tcp6	192.168.1.100:44898	157.240.205.1:443	770003	789553	19550
tcp6	192.168.1.100:44900	157.240.205.1:443	770003	789553	19550
tcp6	192.168.1.100:44902	157.240.205.1:443	770003	830294	60291
tcp6	192.168.1.100:43566	216.58.209.170:443	770003	913129	143126
tcp6	192.168.1.100:38788	216.58.210.131:443	770003	872568	102565
tcp6	192.168.1.100:44904	157.240.205.1:443	770003	817896	47893
tcp6	192.168.1.100:43528	216.58.209.170:443	770003	856703	86700
tcp6	192.168.1.100:35336	103.136.220.205:443	770003	910702	140699
tcp6	192.168.1.100:44894	157.240.205.1:443	770003	817896	47893
tcp6	192.168.1.100:42698	54.177.39.110:443	770003	817896	47893
tcp6	192.168.1.100:44902	157.240.205.1:443	779227	812253	33026
tcp6	192.168.1.100:32966	40.70.161.102:443	779227	872568	93341
tcp6	192.168.1.100:43478	216.58.209.170:443	779227	783757	4530
tcp6	192.168.1.100:38788	216.58.210.131:443	779227	850954	71727
tcp6	192.168.1.100:58316	185.40.30.77:443	779227	783757	4530
tcp6	192.168.1.100:58320	185.40.30.77:443	779227	783757	4530
tcp6	192.168.1.100:44904	157.240.205.1:443	779227	783757	4530
tcp6	192.168.1.100:44894	157.240.205.1:443	779227	783757	4530
tcp6	192.168.1.100:42698	54.177.39.110:443	779227	783757	4530
tcp6	192.168.1.100:47722	34.102.215.127:443	784947	789553	4606
tcp6	192.168.1.100:48180	104.244.42.130:443	784947	810048	25101
tcp6	192.168.1.100:48182	104.244.42.130:443	784947	784947	0
tcp6	192.168.1.100:43612	216.58.209.170:443	784947	882854	97907
tcp6	192.168.1.100:32966	40.70.161.102:443	784947	927972	143025
tcp6	192.168.1.100:43478	216.58.209.170:443	784947	832550	47603
tcp6	192.168.1.100:37104	93.184.220.70:443	784947	857846	72899
tcp6	192.168.1.100:57574	104.244.42.195:443	784947	784947	0
tcp6	192.168.1.100:47734	34.102.215.127:443	786139	885171	99032
tcp6	192.168.1.100:48180	104.244.42.130:443	786139	789553	3414
tcp6	192.168.1.100:48182	104.244.42.130:443	786139	789553	3414
tcp6	192.168.1.100:43612	216.58.209.170:443	786139	789553	3414
tcp6	192.168.1.100:37104	93.184.220.70:443	786139	864596	78457
tcp6	192.168.1.100:57580	104.244.42.195:443	787325	787325	0
tcp6	192.168.1.100:47722	34.102.215.127:443	787325	787325	0
tcp6	192.168.1.100:47734	34.102.215.127:443	787325	890996	103671
tcp6	192.168.1.100:48180	104.244.42.130:443	787325	787325	0
tcp6	192.168.1.100:48182	104.244.42.130:443	787325	787325	0
tcp6	192.168.1.100:43612	216.58.209.170:443	787325	900353	113028
tcp6	192.168.1.100:37104	93.184.220.70:443	787325	871442	84117
tcp6	192.168.1.100:48614	142.250.147.92:443	789553	901571	112018
tcp6	192.168.1.100:37472	13.52.129.247:443	790733	803267	12534
tcp6	192.168.1.100:48560	142.250.147.92:443	790733	803267	12534
tcp6	192.168.1.100:43290	216.58.210.170:443	790733	910702	119969
tcp6	192.168.1.100:44896	157.240.205.1:443	790733	830294	39561
tcp6	192.168.1.100:44898	157.240.205.1:443	790733	830294	39561
tcp6	192.168.1.100:44900	157.240.205.1:443	790733	830294	39561
tcp6	192.168.1.100:47722	34.102.215.127:443	790733	812253	21520
tcp6	192.168.1.100:47734	34.102.215.127:443	790733	879444	88711
tcp6	192.168.1.100:48180	104.244.42.130:443	790733	830294	39561
tcp6	192.168.1.100:48182	104.244.42.130:443	790733	812253	21520
tcp6	192.168.1.100:43612	216.58.209.170:443	790733	856703	65970
tcp6	192.168.1.100:48614	142.250.147.92:443	790733	856703	65970
tcp6	192.168.1.100:37104	93.184.220.70:443	790733	879444	88711
tcp6	192.168.1.100:38788	216.58.210.131:443	790733	879444	88711
tcp6	192.168.1.100:44898	157.240.205.1:443	804395	812253	7858
tcp6	192.168.1.100:44900	157.240.205.1:443	804395	812253	7858
tcp6	192.168.1.100:47722	34.102.215.127:443	804395	810048	5653
tcp6	192.168.1.100:47734	34.102.215.127:443	804395	882854	78459
tcp6	192.168.1.100:48182	104.244.42.130:443	804395	830294	25899
tcp6	192.168.1.100:43612	216.58.209.170:443	804395	864596	60201
tcp6	192.168.1.100:48614	142.250.147.92:443	804395	864596	60201
tcp6	192.168.1.100:42698	54.177.39.110:443	804395	810048	5653
tcp6	192.168.1.100:47722	34.102.215.127:443	813371	830294	16923
tcp6	192.168.1.100:47734	34.102.215.127:443	813371	876002	62631
tcp6	192.168.1.100:48180	104.244.42.130:443	813371	817896	4525
tcp6	192.168.1.100:44902	157.240.205.1:443	813371	831422	18051
tcp6	192.168.1.100:48182	104.244.42.130:443	813371	831422	18051
tcp6	192.168.1.100:43612	216.58.209.170:443	813371	879444	66073
tcp6	192.168.1.100:48614	142.250.147.92:443	813371	879444	66073
tcp6	192.168.1.100:37104	93.184.220.70:443	813371	876002	62631
tcp6	192.168.1.100:44940	157.240.205.1:443	819038	843980	24942
tcp6	192.168.1.100:44942	157.240.205.1:443	819038	830294	11256
tcp6	192.168.1.100:44938	157.240.205.1:443	819038	830294	11256
tcp6	192.168.1.100:48614	142.250.147.92:443	819038	882854	63816
tcp6	192.168.1.100:44900	157.240.205.1:443	831422	831422	0
tcp6	192.168.1.100:47722	34.102.215.127:443	831422	843980	12558
tcp6	192.168.1.100:47734	34.102.215.127:443	831422	872568	41146
tcp6	192.168.1.100:44940	157.240.205.1:443	831422	840588	9166
tcp6	192.168.1.100:48180	104.244.42.130:443	831422	831422	0
tcp6	192.168.1.100:44942	157.240.205.1:443	831422	841701	10279
tcp6	192.168.1.100:44938	157.240.205.1:443	831422	841701	10279
tcp6	192.168.1.100:47718	87.250.250.207:443	831422	833741	2319
tcp6	192.168.1.100:43290	216.58.210.170:443	832550	832550	0
tcp6	192.168.1.100:44900	157.240.205.1:443	832550	832550	0
tcp6	192.168.1.100:47722	34.102.215.127:443	832550	840588	8038
tcp6	192.168.1.100:47734	34.102.215.127:443	832550	840588	8038
tcp6	192.168.1.100:44940	157.240.205.1:443	832550	833741	1191
tcp6	192.168.1.100:48180	104.244.42.130:443	832550	833741	1191
tcp6	192.168.1.100:44942	157.240.205.1:443	832550	840588	8038
tcp6	192.168.1.100:44902	157.240.205.1:443	832550	832550	0
tcp6	192.168.1.100:48182	104.244.42.130:443	832550	832550	0
tcp6	192.168.1.100:43612	216.58.209.170:443	832550	876002	43452
tcp6	192.168.1.100:44948	157.240.205.1:443	832550	849777	17227
tcp6	192.168.1.100:44950	157.240.205.1:443	832550	849777	17227
tcp6	192.168.1.100:44938	157.240.205.1:443	832550	843980	11430
tcp6	192.168.1.100:44946	157.240.205.1:443	832550	847483	14933
tcp6	192.168.1.100:47718	87.250.250.207:443	832550	842817	10267
tcp6	192.168.1.100:42742	54.177.39.110:443	833741	848667	14926
tcp6	192.168.1.100:48182	104.244.42.130:443	833741	833741	0
tcp6	192.168.1.100:43612	216.58.209.170:443	833741	841701	7960
tcp6	192.168.1.100:44948	157.240.205.1:443	833741	841701	7960
tcp6	192.168.1.100:44950	157.240.205.1:443	833741	841701	7960
tcp6	192.168.1.100:44946	157.240.205.1:443	833741	849777	16036
tcp6	192.168.1.100:44958	157.240.205.1:443	834900	840588	5688
tcp6	192.168.1.100:43612	216.58.209.170:443	834900	872568	37668
tcp6	192.168.1.100:44948	157.240.205.1:443	834900	848667	13767
tcp6	192.168.1.100:44950	157.240.205.1:443	834900	848667	13767
tcp6	192.168.1.100:44938	157.240.205.1:443	834900	840588	5688
tcp6	192.168.1.100:44956	157.240.205.1:443	834900	876002	41102
tcp6	192.168.1.100:44954	157.240.205.1:443	834900	877164	42264
tcp6	192.168.1.100:47718	87.250.250.207:443	834900	841701	6801
tcp6	192.168.1.100:37522	13.52.129.247:443	841701	871442	29741
tcp6	192.168.1.100:44958	157.240.205.1:443	841701	872568	30867
tcp6	192.168.1.100:44940	157.240.205.1:443	841701	841701	0
tcp6	192.168.1.100:44956	157.240.205.1:443	841701	879444	37743
tcp6	192.168.1.100:44962	157.240.205.1:443	842817	850954	8137
tcp6	192.168.1.100:47734	34.102.215.127:443	842817	850954	8137
tcp6	192.168.1.100:44958	157.240.205.1:443	842817	850954	8137
tcp6	192.168.1.100:44942	157.240.205.1:443	842817	843980	1163
tcp6	192.168.1.100:44956	157.240.205.1:443	842817	864596	21779
tcp6	192.168.1.100:43528	216.58.209.170:443	842817	864596	21779
tcp6	192.168.1.100:35336	103.136.220.205:443	842817	926803	83986
tcp6	192.168.1.100:44954	157.240.205.1:443	842817	864596	21779
tcp6	192.168.1.100:44964	157.240.205.1:443	842817	865694	22877
tcp6	192.168.1.100:44964	157.240.205.1:443	843980	864596	20616
tcp6	192.168.1.100:44962	157.240.205.1:443	845123	846327	1204
tcp6	192.168.1.100:43612	216.58.209.170:443	845123	846327	1204
tcp6	192.168.1.100:44948	157.240.205.1:443	845123	846327	1204
tcp6	192.168.1.100:44950	157.240.205.1:443	845123	846327	1204
tcp6	192.168.1.100:48614	142.250.147.92:443	845123	846327	1204
tcp6	192.168.1.100:44956	157.240.205.1:443	845123	846327	1204
tcp6	192.168.1.100:44946	157.240.205.1:443	845123	846327	1204
tcp6	192.168.1.100:37104	93.184.220.70:443	845123	846327	1204
tcp6	192.168.1.100:43528	216.58.209.170:443	845123	872568	27445
tcp6	192.168.1.100:35336	103.136.220.205:443	845123	913129	68006
tcp6	192.168.1.100:44954	157.240.205.1:443	845123	872568	27445
tcp6	192.168.1.100:44964	157.240.205.1:443	845123	846327	1204
tcp6	192.168.1.100:48234	104.244.42.130:443	847483	847483	0
tcp6	192.168.1.100:42742	54.177.39.110:443	847483	849777	2294
tcp6	192.168.1.100:37522	13.52.129.247:443	847483	895717	48234
tcp6	192.168.1.100:48230	104.244.42.130:443	847483	847483	0
tcp6	192.168.1.100:48232	104.244.42.130:443	847483	858952	11469
tcp6	192.168.1.100:44962	157.240.205.1:443	847483	864596	17113
tcp6	192.168.1.100:44958	157.240.205.1:443	847483	879444	31961
tcp6	192.168.1.100:48228	104.244.42.130:443	847483	847483	0
tcp6	192.168.1.100:48226	104.244.42.130:443	847483	847483	0
tcp6	192.168.1.100:44954	157.240.205.1:443	847483	865694	18211
tcp6	192.168.1.100:48232	104.244.42.130:443	848667	850954	2287
tcp6	192.168.1.100:48614	142.250.147.92:443	848667	876002	27335
tcp6	192.168.1.100:44956	157.240.205.1:443	848667	848667	0
tcp6	192.168.1.100:44946	157.240.205.1:443	848667	848667	0
tcp6	192.168.1.100:44954	157.240.205.1:443	848667	848667	0
tcp6	192.168.1.100:44964	157.240.205.1:443	848667	848667	0
tcp6	192.168.1.100:48232	104.244.42.130:443	849777	849777	0
tcp6	192.168.1.100:44962	157.240.205.1:443	849777	849777	0
tcp6	192.168.1.100:44958	157.240.205.1:443	849777	876002	26225
tcp6	192.168.1.100:36996	69.195.177.128:443	849777	849777	0
tcp6	192.168.1.100:44964	157.240.205.1:443	849777	857846	8069
tcp6	192.168.1.100:48614	142.250.147.92:443	850954	872568	21614
tcp6	192.168.1.100:43566	216.58.209.170:443	850954	872568	21614
tcp6	192.168.1.100:44956	157.240.205.1:443	850954	872568	21614
tcp6	192.168.1.100:37104	93.184.220.70:443	850954	872568	21614
tcp6	192.168.1.100:43528	216.58.209.170:443	850954	850954	0
tcp6	192.168.1.100:35336	103.136.220.205:443	850954	850954	0
tcp6	192.168.1.100:44954	157.240.205.1:443	850954	850954	0
tcp6	192.168.1.100:44964	157.240.205.1:443	850954	850954	0
tcp6	192.168.1.100:44980	157.240.205.1:443	852152	865694	13542
tcp6	192.168.1.100:44984	157.240.205.1:443	852152	871442	19290
tcp6	192.168.1.100:44986	157.240.205.1:443	852152	864596	12444
tcp6	192.168.1.100:44958	157.240.205.1:443	852152	864596	12444
tcp6	192.168.1.100:44982	157.240.205.1:443	852152	864596	12444
tcp6	192.168.1.100:44954	157.240.205.1:443	852152	879444	27292
tcp6	192.168.1.100:44964	157.240.205.1:443	852152	856703	4551
tcp6	192.168.1.100:38590	213.180.204.244:443	857846	864596	6750
tcp6	192.168.1.100:38592	213.180.204.244:443	858952	865694	6742
tcp6	192.168.1.100:44962	157.240.205.1:443	858952	865694	6742
tcp6	192.168.1.100:44986	157.240.205.1:443	858952	871442	12490
tcp6	192.168.1.100:44958	157.240.205.1:443	858952	882854	23902
tcp6	192.168.1.100:44982	157.240.205.1:443	858952	871442	12490
tcp6	192.168.1.100:38590	213.180.204.244:443	858952	865694	6742
tcp6	192.168.1.100:44956	157.240.205.1:443	858952	871442	12490
tcp6	192.168.1.100:38592	213.180.204.244:443	860108	864596	4488
tcp6	192.168.1.100:42782	54.177.39.110:443	860108	864596	4488
tcp6	192.168.1.100:57480	93.186.225.205:443	865694	927972	62278
tcp6	192.168.1.100:42782	54.177.39.110:443	865694	871442	5748
tcp6	192.168.1.100:44980	157.240.205.1:443	866826	871442	4616
tcp6	192.168.1.100:45000	157.240.205.1:443	866826	866826	0
tcp6	192.168.1.100:38884	216.58.210.131:443	866826	866826	0
tcp6	192.168.1.100:44984	157.240.205.1:443	866826	866826	0
tcp6	192.168.1.100:57480	93.186.225.205:443	866826	936150	69324
tcp6	192.168.1.100:44998	157.240.205.1:443	866826	885171	18345
tcp6	192.168.1.100:38592	213.180.204.244:443	866826	866826	0
tcp6	192.168.1.100:44986	157.240.205.1:443	866826	866826	0
tcp6	192.168.1.100:44958	157.240.205.1:443	866826	885171	18345
tcp6	192.168.1.100:44982	157.240.205.1:443	866826	866826	0
tcp6	192.168.1.100:44996	157.240.205.1:443	866826	871442	4616
tcp6	192.168.1.100:38788	216.58.210.131:443	866826	882854	16028
tcp6	192.168.1.100:44954	157.240.205.1:443	866826	866826	0
tcp6	192.168.1.100:38884	216.58.210.131:443	867973	936150	68177
tcp6	192.168.1.100:44998	157.240.205.1:443	867973	879444	11471
tcp6	192.168.1.100:38592	213.180.204.244:443	867973	871442	3469
tcp6	192.168.1.100:38608	213.180.204.244:443	867973	882854	14881
tcp6	192.168.1.100:45004	157.240.205.1:443	867973	871442	3469
tcp6	192.168.1.100:44954	157.240.205.1:443	867973	882854	14881
tcp6	192.168.1.100:37522	13.52.129.247:443	872568	876002	3434
tcp6	192.168.1.100:38884	216.58.210.131:443	872568	910702	38134
tcp6	192.168.1.100:57480	93.186.225.205:443	872568	872568	0
tcp6	192.168.1.100:44998	157.240.205.1:443	872568	872568	0
tcp6	192.168.1.100:38608	213.180.204.244:443	872568	872568	0
tcp6	192.168.1.100:44996	157.240.205.1:443	872568	872568	0
tcp6	192.168.1.100:45004	157.240.205.1:443	872568	872568	0
tcp6	192.168.1.100:45012	157.240.205.1:443	873666	876002	2336
tcp6	192.168.1.100:45010	157.240.205.1:443	873666	876002	2336
tcp6	192.168.1.100:57480	93.186.225.205:443	873666	913129	39463
tcp6	192.168.1.100:44998	157.240.205.1:443	873666	876002	2336
tcp6	192.168.1.100:38608	213.180.204.244:443	873666	876002	2336
tcp6	192.168.1.100:45008	157.240.205.1:443	873666	876002	2336
tcp6	192.168.1.100:44996	157.240.205.1:443	873666	876002	2336
tcp6	192.168.1.100:45004	157.240.205.1:443	873666	879444	5778
tcp6	192.168.1.100:53920	77.88.21.207:443	877164	890996	13832
tcp6	192.168.1.100:37522	13.52.129.247:443	877164	890996	13832
tcp6	192.168.1.100:38884	216.58.210.131:443	877164	927972	50808
tcp6	192.168.1.100:45012	157.240.205.1:443	877164	879444	2280
tcp6	192.168.1.100:45010	157.240.205.1:443	877164	879444	2280
tcp6	192.168.1.100:38608	213.180.204.244:443	877164	879444	2280
tcp6	192.168.1.100:45008	157.240.205.1:443	877164	879444	2280
tcp6	192.168.1.100:44996	157.240.205.1:443	877164	877164	0
tcp6	192.168.1.100:45004	157.240.205.1:443	877164	877164	0
tcp6	192.168.1.100:45018	157.240.205.1:443	880628	896904	16276
tcp6	192.168.1.100:45012	157.240.205.1:443	880628	882854	2226
tcp6	192.168.1.100:45010	157.240.205.1:443	880628	882854	2226
tcp6	192.168.1.100:45020	157.240.205.1:443	880628	882854	2226
tcp6	192.168.1.100:38906	216.58.210.131:443	880628	902746	22118
tcp6	192.168.1.100:45008	157.240.205.1:443	880628	882854	2226
tcp6	192.168.1.100:44956	157.240.205.1:443	880628	882854	2226
tcp6	192.168.1.100:45022	157.240.205.1:443	880628	882854	2226
tcp6	192.168.1.100:37104	93.184.220.70:443	880628	882854	2226
tcp6	192.168.1.100:42816	54.177.39.110:443	880628	882854	2226
tcp6	192.168.1.100:45004	157.240.205.1:443	880628	882854	2226
tcp6	192.168.1.100:45032	157.240.205.1:443	884013	896904	12891
tcp6	192.168.1.100:45028	157.240.205.1:443	884013	896904	12891
tcp6	192.168.1.100:45012	157.240.205.1:443	884013	884013	0
tcp6	192.168.1.100:45010	157.240.205.1:443	884013	884013	0
tcp6	192.168.1.100:57480	93.186.225.205:443	884013	904999	20986
tcp6	192.168.1.100:44998	157.240.205.1:443	884013	902746	18733
tcp6	192.168.1.100:45020	157.240.205.1:443	884013	896904	12891
tcp6	192.168.1.100:44958	157.240.205.1:443	884013	890996	6983
tcp6	192.168.1.100:38906	216.58.210.131:443	884013	890996	6983
tcp6	192.168.1.100:38608	213.180.204.244:443	884013	890996	6983
tcp6	192.168.1.100:48614	142.250.147.92:443	884013	900353	16340
tcp6	192.168.1.100:45008	157.240.205.1:443	884013	884013	0
tcp6	192.168.1.100:45030	157.240.205.1:443	884013	901571	17558
tcp6	192.168.1.100:44956	157.240.205.1:443	884013	884013	0
tcp6	192.168.1.100:45022	157.240.205.1:443	884013	884013	0
tcp6	192.168.1.100:37104	93.184.220.70:443	884013	884013	0
tcp6	192.168.1.100:38788	216.58.210.131:443	884013	884013	0
tcp6	192.168.1.100:42816	54.177.39.110:443	884013	884013	0
tcp6	192.168.1.100:45004	157.240.205.1:443	884013	901571	17558
tcp6	192.168.1.100:44954	157.240.205.1:443	884013	884013	0
tcp6	192.168.1.100:53452	46.148.238.130:443	885171	909481	24310
tcp6	192.168.1.100:45020	157.240.205.1:443	885171	885171	0
tcp6	192.168.1.100:38906	216.58.210.131:443	885171	896904	11733
tcp6	192.168.1.100:38608	213.180.204.244:443	885171	902746	17575
tcp6	192.168.1.100:39586	192.243.41.138:443	885171	902746	17575
tcp6	192.168.1.100:45030	157.240.205.1:443	885171	902746	17575
tcp6	192.168.1.100:44956	157.240.205.1:443	885171	885171	0
tcp6	192.168.1.100:45022	157.240.205.1:443	885171	885171	0
tcp6	192.168.1.100:37104	93.184.220.70:443	885171	885171	0
tcp6	192.168.1.100:38788	216.58.210.131:443	885171	885171	0
tcp6	192.168.1.100:45004	157.240.205.1:443	885171	885171	0
tcp6	192.168.1.100:44954	157.240.205.1:443	885171	885171	0
tcp6	192.168.1.100:45038	157.240.205.1:443	886330	909481	23151
tcp6	192.168.1.100:57480	93.186.225.205:443	886330	909481	23151
tcp6	192.168.1.100:44998	157.240.205.1:443	886330	890996	4666
tcp6	192.168.1.100:53452	46.148.238.130:443	886330	904999	18669
tcp6	192.168.1.100:39586	192.243.41.138:443	886330	890996	4666
tcp6	192.168.1.100:43612	216.58.209.170:443	886330	890996	4666
tcp6	192.168.1.100:48614	142.250.147.92:443	886330	890996	4666
tcp6	192.168.1.100:45044	157.240.205.1:443	886330	890996	4666
tcp6	192.168.1.100:43566	216.58.209.170:443	886330	900353	14023
tcp6	192.168.1.100:45030	157.240.205.1:443	886330	900353	14023
tcp6	192.168.1.100:44956	157.240.205.1:443	886330	890996	4666
tcp6	192.168.1.100:45040	157.240.205.1:443	886330	900353	14023
tcp6	192.168.1.100:45022	157.240.205.1:443	886330	889806	3476
tcp6	192.168.1.100:37104	93.184.220.70:443	886330	889806	3476
tcp6	192.168.1.100:38788	216.58.210.131:443	886330	889806	3476
tcp6	192.168.1.100:45042	157.240.205.1:443	886330	889806	3476
tcp6	192.168.1.100:45004	157.240.205.1:443	886330	889806	3476
tcp6	192.168.1.100:35336	103.136.220.205:443	886330	889806	3476
tcp6	192.168.1.100:44954	157.240.205.1:443	886330	889806	3476
tcp6	192.168.1.100:44338	64.233.165.188:5228	886330	889806	3476
tcp6	192.168.1.100:57532	93.186.225.205:443	890996	890996	0
tcp6	192.168.1.100:45040	157.240.205.1:443	890996	890996	0
tcp6	192.168.1.100:45022	157.240.205.1:443	890996	890996	0
tcp6	192.168.1.100:37104	93.184.220.70:443	890996	890996	0
tcp6	192.168.1.100:38788	216.58.210.131:443	890996	890996	0
tcp6	192.168.1.100:45042	157.240.205.1:443	890996	895717	4721
tcp6	192.168.1.100:54490	216.58.209.206:443	890996	895717	4721
tcp6	192.168.1.100:45004	157.240.205.1:443	890996	895717	4721
tcp6	192.168.1.100:35336	103.136.220.205:443	890996	895717	4721
tcp6	192.168.1.100:44954	157.240.205.1:443	890996	895717	4721
tcp6	192.168.1.100:44338	64.233.165.188:5228	890996	895717	4721
tcp6	192.168.1.100:38652	213.180.204.244:443	892166	927972	35806
tcp6	192.168.1.100:47828	87.250.250.207:443	892166	904999	12833
tcp6	192.168.1.100:53920	77.88.21.207:443	892166	895717	3551
tcp6	192.168.1.100:45018	157.240.205.1:443	892166	895717	3551
tcp6	192.168.1.100:38884	216.58.210.131:443	892166	895717	3551
tcp6	192.168.1.100:45032	157.240.205.1:443	892166	895717	3551
tcp6	192.168.1.100:43290	216.58.210.170:443	892166	895717	3551
tcp6	192.168.1.100:45028	157.240.205.1:443	892166	895717	3551
tcp6	192.168.1.100:42842	54.177.39.110:443	892166	895717	3551
tcp6	192.168.1.100:45038	157.240.205.1:443	892166	895717	3551
tcp6	192.168.1.100:57480	93.186.225.205:443	892166	895717	3551
tcp6	192.168.1.100:44998	157.240.205.1:443	892166	895717	3551
tcp6	192.168.1.100:53452	46.148.238.130:443	892166	895717	3551
tcp6	192.168.1.100:47734	34.102.215.127:443	892166	893366	1200
tcp6	192.168.1.100:45020	157.240.205.1:443	892166	893366	1200
tcp6	192.168.1.100:44958	157.240.205.1:443	892166	893366	1200
tcp6	192.168.1.100:38906	216.58.210.131:443	892166	893366	1200
tcp6	192.168.1.100:38608	213.180.204.244:443	892166	893366	1200
tcp6	192.168.1.100:39586	192.243.41.138:443	892166	893366	1200
tcp6	192.168.1.100:43612	216.58.209.170:443	892166	893366	1200
tcp6	192.168.1.100:48614	142.250.147.92:443	892166	893366	1200
tcp6	192.168.1.100:45044	157.240.205.1:443	892166	893366	1200
tcp6	192.168.1.100:43566	216.58.209.170:443	892166	893366	1200
tcp6	192.168.1.100:45030	157.240.205.1:443	892166	893366	1200
tcp6	192.168.1.100:44956	157.240.205.1:443	892166	893366	1200
tcp6	192.168.1.100:57532	93.186.225.205:443	892166	893366	1200
tcp6	192.168.1.100:32966	40.70.161.102:443	892166	893366	1200
tcp6	192.168.1.100:45040	157.240.205.1:443	892166	893366	1200
tcp6	192.168.1.100:45022	157.240.205.1:443	892166	893366	1200
tcp6	192.168.1.100:37104	93.184.220.70:443	892166	893366	1200
tcp6	192.168.1.100:38788	216.58.210.131:443	892166	892166	0
tcp6	192.168.1.100:45042	157.240.205.1:443	892166	892166	0
tcp6	192.168.1.100:54490	216.58.209.206:443	892166	892166	0
tcp6	192.168.1.100:45004	157.240.205.1:443	892166	892166	0
tcp6	192.168.1.100:35336	103.136.220.205:443	892166	892166	0
tcp6	192.168.1.100:44954	157.240.205.1:443	892166	892166	0
tcp6	192.168.1.100:44338	64.233.165.188:5228	892166	892166	0
tcp6	192.168.1.100:45042	157.240.205.1:443	893366	893366	0
tcp6	192.168.1.100:54490	216.58.209.206:443	893366	893366	0
tcp6	192.168.1.100:45004	157.240.205.1:443	893366	893366	0
tcp6	192.168.1.100:35336	103.136.220.205:443	893366	893366	0
tcp6	192.168.1.100:44954	157.240.205.1:443	893366	893366	0
tcp6	192.168.1.100:44338	64.233.165.188:5228	893366	893366	0
tcp6	192.168.1.100:45020	157.240.205.1:443	894572	895717	1145
tcp6	192.168.1.100:44958	157.240.205.1:443	894572	895717	1145
tcp6	192.168.1.100:38906	216.58.210.131:443	894572	895717	1145
tcp6	192.168.1.100:38608	213.180.204.244:443	894572	895717	1145
tcp6	192.168.1.100:39586	192.243.41.138:443	894572	895717	1145
tcp6	192.168.1.100:43612	216.58.209.170:443	894572	895717	1145
tcp6	192.168.1.100:48614	142.250.147.92:443	894572	895717	1145
tcp6	192.168.1.100:45044	157.240.205.1:443	894572	895717	1145
tcp6	192.168.1.100:43566	216.58.209.170:443	894572	895717	1145
tcp6	192.168.1.100:45030	157.240.205.1:443	894572	895717	1145
tcp6	192.168.1.100:44956	157.240.205.1:443	894572	895717	1145
tcp6	192.168.1.100:57532	93.186.225.205:443	894572	895717	1145
tcp6	192.168.1.100:32966	40.70.161.102:443	894572	895717	1145
tcp6	192.168.1.100:45040	157.240.205.1:443	894572	895717	1145
tcp6	192.168.1.100:45022	157.240.205.1:443	894572	895717	1145
tcp6	192.168.1.100:42842	54.177.39.110:443	896904	896904	0
tcp6	192.168.1.100:45038	157.240.205.1:443	896904	904999	8095
tcp6	192.168.1.100:53452	46.148.238.130:443	896904	902746	5842
tcp6	192.168.1.100:45044	157.240.205.1:443	896904	900353	3449
tcp6	192.168.1.100:57532	93.186.225.205:443	896904	901571	4667
tcp6	192.168.1.100:45040	157.240.205.1:443	896904	901571	4667
tcp6	192.168.1.100:45022	157.240.205.1:443	896904	896904	0
tcp6	192.168.1.100:45042	157.240.205.1:443	896904	900353	3449
tcp6	192.168.1.100:54490	216.58.209.206:443	896904	901571	4667
tcp6	192.168.1.100:45032	157.240.205.1:443	898064	904999	6935
tcp6	192.168.1.100:45028	157.240.205.1:443	898064	904999	6935
tcp6	192.168.1.100:42842	54.177.39.110:443	898064	904999	6935
tcp6	192.168.1.100:45058	157.240.205.1:443	898064	904999	6935
tcp6	192.168.1.100:45060	157.240.205.1:443	898064	902746	4682
tcp6	192.168.1.100:45056	157.240.205.1:443	898064	900353	2289
tcp6	192.168.1.100:57532	93.186.225.205:443	898064	900353	2289
tcp6	192.168.1.100:37624	13.52.129.247:443	898064	900353	2289
tcp6	192.168.1.100:54490	216.58.209.206:443	898064	900353	2289
tcp6	192.168.1.100:45004	157.240.205.1:443	898064	900353	2289
tcp6	192.168.1.100:45044	157.240.205.1:443	901571	901571	0
tcp6	192.168.1.100:45056	157.240.205.1:443	901571	901571	0
tcp6	192.168.1.100:45042	157.240.205.1:443	901571	901571	0
tcp6	192.168.1.100:37624	13.52.129.247:443	901571	901571	0
tcp6	192.168.1.100:45044	157.240.205.1:443	902746	902746	0
tcp6	192.168.1.100:45056	157.240.205.1:443	902746	902746	0
tcp6	192.168.1.100:57532	93.186.225.205:443	902746	902746	0
tcp6	192.168.1.100:45040	157.240.205.1:443	902746	902746	0
tcp6	192.168.1.100:45042	157.240.205.1:443	902746	902746	0
tcp6	192.168.1.100:37624	13.52.129.247:443	902746	902746	0
tcp6	192.168.1.100:54490	216.58.209.206:443	902746	902746	0
tcp6	192.168.1.100:45004	157.240.205.1:443	902746	902746	0
tcp6	192.168.1.100:38906	216.58.210.131:443	903885	904999	1114
tcp6	192.168.1.100:45060	157.240.205.1:443	903885	904999	1114
tcp6	192.168.1.100:39586	192.243.41.138:443	903885	904999	1114
tcp6	192.168.1.100:45044	157.240.205.1:443	903885	904999	1114
tcp6	192.168.1.100:45056	157.240.205.1:443	903885	904999	1114
tcp6	192.168.1.100:45030	157.240.205.1:443	903885	904999	1114
tcp6	192.168.1.100:57532	93.186.225.205:443	903885	904999	1114
tcp6	192.168.1.100:45040	157.240.205.1:443	903885	904999	1114
tcp6	192.168.1.100:45042	157.240.205.1:443	903885	904999	1114
tcp6	192.168.1.100:37624	13.52.129.247:443	903885	904999	1114
tcp6	192.168.1.100:54490	216.58.209.206:443	903885	904999	1114
tcp6	192.168.1.100:45032	157.240.205.1:443	906096	909481	3385
tcp6	192.168.1.100:45028	157.240.205.1:443	906096	909481	3385
tcp6	192.168.1.100:42842	54.177.39.110:443	906096	909481	3385
tcp6	192.168.1.100:45058	157.240.205.1:443	906096	936150	30054
tcp6	192.168.1.100:38906	216.58.210.131:443	906096	909481	3385
tcp6	192.168.1.100:45060	157.240.205.1:443	906096	909481	3385
tcp6	192.168.1.100:39586	192.243.41.138:443	906096	936150	30054
tcp6	192.168.1.100:45044	157.240.205.1:443	906096	909481	3385
tcp6	192.168.1.100:45056	157.240.205.1:443	906096	936150	30054
tcp6	192.168.1.100:45030	157.240.205.1:443	906096	909481	3385
tcp6	192.168.1.100:57532	93.186.225.205:443	906096	909481	3385
tcp6	192.168.1.100:45040	157.240.205.1:443	906096	909481	3385
tcp6	192.168.1.100:45042	157.240.205.1:443	906096	909481	3385
tcp6	192.168.1.100:37624	13.52.129.247:443	906096	909481	3385
tcp6	192.168.1.100:54490	216.58.209.206:443	906096	909481	3385
tcp6	192.168.1.100:42842	54.177.39.110:443	910702	910702	0
tcp6	192.168.1.100:45058	157.240.205.1:443	910702	913129	2427
tcp6	192.168.1.100:45038	157.240.205.1:443	910702	910702	0
tcp6	192.168.1.100:53452	46.148.238.130:443	910702	927972	17270
tcp6	192.168.1.100:38906	216.58.210.131:443	910702	927972	17270
tcp6	192.168.1.100:45060	157.240.205.1:443	910702	927972	17270
tcp6	192.168.1.100:39586	192.243.41.138:443	910702	926803	16101
tcp6	192.168.1.100:45044	157.240.205.1:443	910702	910702	0
tcp6	192.168.1.100:45056	157.240.205.1:443	910702	926803	16101
tcp6	192.168.1.100:57532	93.186.225.205:443	910702	926803	16101
tcp6	192.168.1.100:45040	157.240.205.1:443	910702	910702	0
tcp6	192.168.1.100:45042	157.240.205.1:443	910702	910702	0
tcp6	192.168.1.100:37624	13.52.129.247:443	910702	927972	17270
tcp6	192.168.1.100:54490	216.58.209.206:443	910702	927972	17270
tcp6	192.168.1.100:58978	104.244.42.2:443	911905	927972	16067
tcp6	192.168.1.100:53452	46.148.238.130:443	911905	913129	1224
tcp6	192.168.1.100:38906	216.58.210.131:443	911905	913129	1224
tcp6	192.168.1.100:45060	157.240.205.1:443	911905	913129	1224
tcp6	192.168.1.100:39586	192.243.41.138:443	911905	913129	1224
tcp6	192.168.1.100:45072	157.240.205.1:443	911905	913129	1224
tcp6	192.168.1.100:45056	157.240.205.1:443	911905	913129	1224
tcp6	192.168.1.100:57532	93.186.225.205:443	911905	913129	1224
tcp6	192.168.1.100:37624	13.52.129.247:443	911905	913129	1224
tcp6	192.168.1.100:54490	216.58.209.206:443	911905	913129	1224
tcp6	192.168.1.100:45074	157.240.205.1:443	911905	913129	1224
tcp6	192.168.1.100:45078	157.240.205.1:443	914303	927972	13669
tcp6	192.168.1.100:45058	157.240.205.1:443	914303	927972	13669
tcp6	192.168.1.100:37104	69.195.177.128:443	914303	914303	0
tcp6	192.168.1.100:53452	46.148.238.130:443	914303	936150	21847
tcp6	192.168.1.100:38906	216.58.210.131:443	914303	936150	21847
tcp6	192.168.1.100:45060	157.240.205.1:443	914303	936150	21847
tcp6	192.168.1.100:39586	192.243.41.138:443	914303	927972	13669
tcp6	192.168.1.100:45072	157.240.205.1:443	914303	927972	13669
tcp6	192.168.1.100:45056	157.240.205.1:443	914303	927972	13669
tcp6	192.168.1.100:57532	93.186.225.205:443	914303	927972	13669
tcp6	192.168.1.100:45082	157.240.205.1:443	914303	927972	13669
tcp6	192.168.1.100:45080	157.240.205.1:443	914303	927972	13669
tcp6	192.168.1.100:45074	157.240.205.1:443	914303	926803	12500
tcp6	192.168.1.100:45072	157.240.205.1:443	915467	926803	11336
tcp6	192.168.1.100:45082	157.240.205.1:443	915467	926803	11336
tcp6	192.168.1.100:37624	13.52.129.247:443	915467	926803	11336
tcp6	192.168.1.100:54490	216.58.209.206:443	915467	926803	11336
tcp6	192.168.1.100:45080	157.240.205.1:443	915467	926803	11336
tcp6	192.168.1.100:45074	157.240.205.1:443	915467	923364	7897
tcp6	192.168.1.100:42876	54.177.39.110:443	924519	926803	2284
tcp6	192.168.1.100:38970	216.58.210.131:443	927972	927972	0
tcp6	192.168.1.100:42876	54.177.39.110:443	927972	927972	0
tcp6	192.168.1.100:45074	157.240.205.1:443	927972	927972	0
tcp6	192.168.1.100:38652	213.180.204.244:443	929191	929191	0
tcp6	192.168.1.100:45078	157.240.205.1:443	929191	936150	6959
tcp6	192.168.1.100:38970	216.58.210.131:443	929191	936150	6959
tcp6	192.168.1.100:45072	157.240.205.1:443	929191	936150	6959
tcp6	192.168.1.100:57532	93.186.225.205:443	929191	936150	6959
tcp6	192.168.1.100:45082	157.240.205.1:443	929191	936150	6959
tcp6	192.168.1.100:37624	13.52.129.247:443	929191	936150	6959
tcp6	192.168.1.100:54490	216.58.209.206:443	929191	936150	6959
tcp6	192.168.1.100:45080	157.240.205.1:443	929191	936150	6959
tcp6	192.168.1.100:42876	54.177.39.110:443	929191	936150	6959
tcp6	192.168.1.100:45074	157.240.205.1:443	929191	936150	6959
tcp6	192.168.1.100:47864	87.250.250.207:443	930393	936150	5757