#time	step	pss	shared_dirty	private_dirty	heap_size	heap_alloc	heap_free	native_pss	native_shared_dirty	native_private_dirty	native_heap_size	native_heap_alloc	native_heap_free	dalvik_pss	dalvik_shared_dirty	dalvik_private_dirty	dalvik_heap_size	dalvik_heap_alloc	dalvik_heap_free
2160	0	43520		16284	19449	10429	9019	5713		5568	16384	8130	8253	4120		3848	3065	2299	766
3176	0	42891		15872	19437	10412	9024	5713		5568	16384	8122	8261	3672		3420	3053	2290	763
4180	0	43015		15860	19436	10416	9019	5713		5568	16384	8127	8256	3660		3408	3052	2289	763
5195	0	0	0	0	0	0	0	0	0	0	0	0	0	0	0	0	0	0	0
7219	1	52011		40735	17628	11492	6135	5663		5616	14336	9846	4489	1733		1708	3292	1646	1646
8220	1	48546		36571	18430	12182	6247	6659		6616	14336	10135	4200	2665		2412	4094	2047	2047
9226	2	48301		36295	18449	11987	6461	6669		6628	14336	9930	4405	2616		2364	4113	2057	2056
10241	4	48566		36299	18449	11988	6460	6669		6628	14336	9931	4404	2620		2368	4113	2057	2056
11252	5	48621		36459	18482	12045	6436	6673		6632	14336	9972	4363	2768		2516	4146	2073	2073
12265	6	48903		36403	18451	12030	6420	6673		6632	14336	9972	4363	2712		2460	4115	2058	2057
13272	7	48892		36427	18452	12031	6420	6673		6632	14336	9973	4362	2732		2480	4116	2058	2058
14275	7	48644		36463	18452	12180	6271	6709		6668	14336	10122	4213	2720		2468	4116	2058	2058
15277	9	48790		36631	18453	12182	6270	6713		6672	14336	10123	4212	2884		2632	4117	2059	2058
16280	9	48937		36515	18453	12218	6234	6713		6672	14336	10159	4176	2756		2504	4117	2059	2058
17282	10	49074		36519	18453	12220	6232	6713		6672	14336	10161	4174	2760		2508	4117	2059	2058
18297	11	49087		36515	18454	12221	6232	6713		6672	14336	10162	4173	2756		2504	4118	2059	2059
19313	12	49073		36507	18453	12220	6232	6713		6672	14336	10161	4174	2748		2496	4117	2059	2058
20328	13	49080		36511	18453	12221	6231	6713		6672	14336	10162	4173	2752		2500	4117	2059	2058
21343	14	49085		36523	18454	12220	6233	6713		6672	14336	10161	4174	2764		2512	4118	2059	2059
22345	15	49064		36511	18453	12217	6235	6713		6672	14336	10158	4177	2752		2500	4117	2059	2058
23346	16	49085		36531	18454	12223	6230	6713		6672	14336	10164	4171	2772		2520	4118	2059	2059
24361	17	48743		36535	18454	12214	6239	6729		6688	14336	10155	4180	2760		2508	4118	2059	2059
25365	18	49045		36463	18454	12181	6272	6661		6620	14336	10122	4213	2756		2504	4118	2059	2059
26368	19	48853		36475	18454	12154	6299	6661		6620	14336	10095	4240	2768		2516	4118	2059	2059
27383	19	48844		36463	18453	12097	6355	6661		6620	14336	10038	4297	2756		2504	4117	2059	2058
28390	21	48854		36475	18454	12098	6355	6661		6620	14336	10039	4296	2768		2516	4118	2059	2059
29406	22	48832		36459	18453	12098	6354	6661		6620	14336	10039	4296	2752		2500	4117	2059	2058
30414	22	48837		36463	18453	12097	6355	6661		6620	14336	10038	4297	2756		2504	4117	2059	2058
31428	23	48998		36475	18454	12098	6355	6661		6620	14336	10039	4296	2768		2516	4118	2059	2059
32431	24	48978		36463	18453	12097	6355	6661		6620	14336	10038	4297	2756		2504	4117	2059	2058
33440	25	48985		36467	18454	12096	6357	6661		6620	14336	10037	4298	2760		2508	4118	2059	2059
34454	26	48975		36459	18453	12089	6363	6661		6620	14336	10030	4305	2752		2500	4117	2059	2058
35457	27	48992		36463	18453	12082	6370	6657		6616	14336	10023	4312	2760		2508	4117	2059	2058
36466	28	48981		36471	18454	12068	6385	6657		6616	14336	10009	4326	2768		2516	4118	2059	2059
37472	29	48589		36463	18453	12053	6399	6657		6616	14336	9994	4341	2760		2508	4117	2059	2058
38480	30	48820		36463	18453	12053	6399	6657		6616	14336	9994	4341	2760		2508	4117	2059	2058
39495	31	48594		36475	18454	12052	6401	6657		6616	14336	9993	4342	2772		2520	4118	2059	2059
40509	32	49076		36463	18453	12054	6398	6659		6616	14336	9995	4340	2761		2508	4117	2059	2058
41519	33	49079		36475	18486	12070	6415	6659		6616	14336	9995	4340	2773		2520	4150	2075	2075
42525	34	49075		36463	18453	12053	6399	6659		6616	14336	9994	4341	2761		2508	4117	2059	2058
43541	35	49074		36463	18454	12054	6399	6659		6616	14336	9995	4340	2761		2508	4118	2059	2059
44545	36	49056		36487	18455	12054	6400	6662		6624	14336	9994	4341	2773		2520	4119	2060	2059
45554	37	48982		36475	18455	12052	6402	6662		6624	14336	9992	4343	2760		2508	4119	2060	2059
46564	37	48970		36487	18455	12053	6401	6662		6624	14336	9993	4342	2772		2520	4119	2060	2059
47577	39	48914		36475	18455	12052	6402	6662		6624	14336	9992	4343	2760		2508	4119	2060	2059
48591	39	48918		36475	18455	12052	6402	6662		6624	14336	9992	4343	2760		2508	4119	2060	2059
49605	40	49041		36487	18455	12053	6401	6662		6624	14336	9993	4342	2772		2520	4119	2060	2059
50620	41	49060		36471	18455	12052	6402	6662		6624	14336	9992	4343	2756		2504	4119	2060	2059
51634	42	49120		36531	18456	12210	6245	6706		6668	14336	10150	4185	2772		2520	4120	2060	2060
52647	43	49104		36519	18455	12225	6229	6706		6668	14336	10149	4186	2760		2508	4119	2076	2043
53662	44	49106		36519	18455	12208	6246	6706		6668	14336	10148	4187	2760		2508	4119	2060	2059
54673	45	49132		36543	18456	12213	6242	6710		6672	14336	10153	4182	2780		2528	4120	2060	2060
55679	46	49107		36527	18456	12212	6243	6710		6672	14336	10152	4183	2764		2512	4120	2060	2060
56694	47	49113		36543	18456	12211	6244	6710		6672	14336	10151	4184	2780		2528	4120	2060	2060
57695	48	49095		36527	18456	12213	6242	6710		6672	14336	10153	4182	2764		2512	4120	2060	2060
58707	49	59917		46427	18545	13717	4827	7058		7020	14336	11612	2723	2788		2536	4209	2105	2104
59708	50	88302		61615	21000	15096	5903	9700		9656	16384	12788	3595	4676		4424	4616	2308	2308
60710	51	87064		60475	20992	14928	6063	9852		9808	16384	12624	3759	3384		3132	4608	2304	2304
61724	52	86767		59818	21017	14780	6236	9692		9648	16384	12463	3920	3652		3400	4633	2317	2316
62740	52	87110		60094	21039	14757	6281	9732		9688	16384	12429	3954	3864		3612	4655	2328	2327
63760	53	86621		59970	21008	14732	6275	9716		9672	16384	12420	3963	3752		3500	4624	2312	2312
64760	54	87258		60034	20989	14683	6305	9684		9640	16384	12380	4003	3848		3596	4605	2303	2302
65762	54	87785		60859	21026	14743	6282	9692		9648	16384	12422	3961	3880		3628	4642	2321	2321
66768	56	87168		60186	21062	14900	6161	9712		9668	16384	12561	3822	3940		3688	4678	2339	2339
67782	58	87808		60963	21095	14860	6234	9700		9656	16384	12504	3879	3952		3700	4711	2356	2355
68787	59	88137		61067	21061	14822	6238	9704		9660	16384	12483	3900	4052		3800	4677	2339	2338
69797	59	87210		60246	21025	14841	6183	9712		9668	16384	12520	3863	3988		3736	4641	2321	2320
70811	60	87275		60318	21089	14850	6238	9731		9692	16384	12497	3886	4036		3784	4705	2353	2352
71815	61	87520		61047	21026	14845	6180	9722		9684	16384	12508	3875	4007		3756	4642	2337	2305
72819	62	87756		61083	21090	14866	6223	9738		9700	16384	12513	3870	4025		3776	4706	2353	2353
73821	62	86575		60298	21090	14872	6217	9742		9704	16384	12519	3864	4003		3752	4706	2353	2353
74836	63	87660		61083	21028	14815	6212	9730		9692	16384	12493	3890	4035		3784	4644	2322	2322
75843	64	86899		60326	21059	14844	6214	9714		9676	16384	12506	3877	4059		3808	4675	2338	2337
76856	64	86212		59553	21026	14825	6200	9726		9688	16384	12504	3879	4039		3788	4642	2321	2321
77866	65	86680		60314	21058	14847	6210	9706		9668	16384	12510	3873	4055		3804	4674	2337	2337
78881	66	85876		59593	21026	14790	6235	9734		9696	16384	12469	3914	4071		3820	4642	2321	2321
79897	67	86913		60350	21031	14774	6256	9738		9700	16384	12450	3933	4059		3808	4647	2324	2323
80903	68	86792		60310	21034	14754	6279	9686		9648	16384	12429	3954	4071		3820	4650	2325	2325
81905	69	86622		60298	21031	14775	6255	9686		9648	16384	12451	3932	4059		3808	4647	2324	2323
82904	70	87418		60346	21027	14771	6255	9710		9672	16384	12449	3934	4084		3832	4643	2322	2321
83910	70	87379		60306	21027	14780	6246	9698		9660	16384	12458	3925	4056		3804	4643	2322	2321
84915	71	87503		60342	21027	14786	6240	9706		9668	16384	12464	3919	4084		3832	4643	2322	2321
85929	72	87469		60326	20996	14747	6248	9698		9660	16384	12441	3942	4076		3824	4612	2306	2306
86933	73	86037		59497	21028	14767	6260	9698		9660	16384	12445	3938	4012		3760	4644	2322	2322
87941	74	87735		60987	21028	14796	6231	9702		9664	16384	12458	3925	3967		3716	4644	2338	2306
88942	74	87386		60987	20996	14740	6255	9694		9656	16384	12434	3949	3975		3724	4612	2306	2306
89951	74	87030		60234	21028	14761	6266	9694		9656	16384	12439	3944	3983		3736	4644	2322	2322
90967	75	86720		60298	21028	14931	6096	9710		9672	16384	12609	3774	4035		3784	4644	2322	2322
91971	75	86921		60262	21029	14982	6046	9726		9688	16384	12643	3740	3983		3732	4645	2339	2306
92974	76	87823		61043	21065	14975	6089	9706		9668	16384	12634	3749	4019		3768	4681	2341	2340
93986	76	87201		60322	21034	14953	6080	9718		9680	16384	12628	3755	4051		3800	4650	2325	2325
95003	77	86713		60334	21032	14961	6070	9726		9688	16384	12637	3746	4055		3804	4648	2324	2324
96017	78	86245		59565	21028	14927	6100	9698		9660	16384	12605	3778	4079		3828	4644	2322	2322
97031	78	87094		60342	21028	14931	6096	9690		9652	16384	12609	3774	4099		3848	4644	2322	2322
98043	79	85852		59561	21028	14986	6041	9693		9656	16384	12648	3735	4079		3828	4644	2338	2306
99058	80	86893		60294	21060	14969	6090	9701		9664	16384	12631	3752	4039		3788	4676	2338	2338
100070	80	86552		60302	21062	14969	6092	9697		9660	16384	12630	3753	4051		3800	4678	2339	2339
101083	81	86055		59493	21029	14920	6108	9685		9648	16384	12597	3786	4019		3768	4645	2323	2322
102084	81	86968		60326	21029	14942	6086	9685		9648	16384	12619	3764	4087		3836	4645	2323	2322
103087	82	87891		61663	20996	14944	6051	9701		9664	16384	12622	3761	4643		4392	4612	2322	2290
104090	83	86079		59521	20996	14940	6055	9701		9664	16384	12634	3749	4031		3780	4612	2306	2306
105091	83	86459		60230	20996	14914	6081	9681		9644	16384	12608	3775	3995		3744	4612	2306	2306
106105	84	86774		60310	21035	14945	6089	9689		9652	16384	12619	3764	4067		3816	4651	2326	2325
107115	84	87474		61099	21035	14955	6079	9701		9664	16384	12629	3754	4079		3828	4651	2326	2325
108128	85	86534		60326	21065	14957	6107	9705		9668	16384	12616	3767	4067		3816	4681	2341	2340
109144	85	86095		59513	21060	14971	6088	9693		9656	16384	12633	3750	4031		3780	4676	2338	2338
110160	86	86527		60326	21028	14968	6059	9693		9656	16384	12646	3737	4079		3828	4644	2322	2322
111161	87	86789		60314	20996	14888	6107	9701		9664	16384	12582	3801	4059		3808	4612	2306	2306
112168	88	86092		59541	20996	14867	6128	9701		9664	16384	12561	3822	4051		3800	4612	2306	2306
113177	88	86445		60270	21028	14836	6191	9681		9644	16384	12514	3869	4035		3784	4644	2322	2322
114182	89	87212		61039	20996	14790	6205	9701		9664	16384	12484	3899	4019		3768	4612	2306	2306
115195	89	86821		60274	20996	14777	6218	9693		9656	16384	12471	3912	4027		3776	4612	2306	2306
116209	90	87197		61031	20996	14795	6200	9693		9656	16384	12489	3894	4019		3768	4612	2306	2306
117217	91	86740		60278	20996	14761	6234	9697		9660	16384	12455	3928	4027		3776	4612	2306	2306
118229	91	86078		59529	20996	14770	6225	9709		9672	16384	12464	3919	4031		3780	4612	2306	2306
119243	92	82878		56702	20967	14466	6500	9677		9640	16384	12158	4225	3983		3732	4583	2308	2275
120244	93	73234		46810	20966	14134	6831	9629		9592	16384	11843	4540	3891		3640	4582	2291	2291
121257	94	76715		50018	21064	14578	6485	9469		9432	16384	12238	4145	3991		3740	4680	2340	2340
122271	94	77588		50959	21036	14735	6300	9549		9512	16384	12409	3974	4083		3832	4652	2326	2326
123285	95	75738		49601	21062	14733	6329	9545		9508	16384	12394	3990	4099		3848	4678	2339	2339
124293	96	76485		50378	21029	14678	6350	9557		9520	16384	12355	4028	4099		3848	4645	2323	2322
125294	97	77572		51135	21030	14693	6336	9533		9496	16384	12370	4013	4111		3864	4646	2323	2323
126307	97	76843		50322	20997	14685	6311	9557		9520	16384	12378	4005	4039		3792	4613	2307	2306
127316	98	75701		49549	20998	14718	6279	9557		9520	16384	12411	3972	4031		3784	4614	2307	2307
128320	99	75808		49541	20997	14698	6298	9545		9508	16384	12391	3992	4035		3788	4613	2307	2306
129327	100	76760		50318	20998	14688	6309	9545		9508	16384	12381	4002	4047		3800	4614	2307	2307
130340	100	76855		50330	20997	14683	6313	9561		9524	16384	12376	4007	4043		3796	4613	2307	2306
131340	101	76452		50314	20997	14690	6306	9549		9512	16384	12383	4000	4039		3792	4613	2307	2306
132347	102	77508		51067	20997	14664	6332	9529		9492	16384	12357	4026	4047		3800	4613	2307	2306
133357	102	77076		50334	21034	14720	6313	9541		9504	16384	12395	3988	4067		3820	4650	2325	2325
134371	103	76683		50374	21036	14733	6302	9545		9508	16384	12407	3976	4103		3856	4652	2326	2326
135373	104	76470		50366	21034	14736	6297	9553		9516	16384	12411	3972	4087		3840	4650	2325	2325
136387	105	77590		51151	21030	14733	6296	9541		9504	16384	12410	3973	4119		3872	4646	2323	2323
137400	105	76115		49593	21029	14717	6311	9545		9508	16384	12394	3989	4087		3840	4645	2323	2322
138412	106	76518		50382	21029	14718	6310	9554		9516	16384	12395	3988	4103		3856	4645	2323	2322
139415	107	76494		50394	21029	14708	6320	9554		9516	16384	12385	3998	4115		3868	4645	2323	2322
140428	108	76832		50402	21030	14708	6321	9542		9504	16384	12385	3998	4135		3888	4646	2323	2323
141445	108	76069		49597	20997	14708	6288	9541		9504	16384	12401	3982	4095		3848	4613	2307	2306
142447	109	76367		50326	20997	14774	6222	9557		9520	16384	12451	3932	4041		3796	4613	2323	2290
143464	110	76524		50338	20997	14779	6217	9561		9524	16384	12456	3927	4049		3804	4613	2323	2290
144477	110	76116		50306	20998	14757	6240	9549		9512	16384	12450	3933	4029		3784	4614	2307	2307
145492	111	77272		51051	21061	14759	6301	9549		9512	16384	12420	3963	4009		3764	4677	2339	2338
146504	111	77339		51135	21035	14764	6270	9565		9528	16384	12438	3945	4077		3832	4651	2326	2325
147512	112	76352		50394	21069	14766	6309	9565		9528	16384	12423	3967	4101		3856	4685	2343	2342
148513	113	77161		51087	21033	14775	6257	9533		9496	16384	12450	3933	4061		3816	4649	2325	2324
149528	113	75411		49617	21029	14746	6282	9553		9516	16384	12423	3960	4101		3856	4645	2323	2322
150543	114	76175		50406	21030	14756	6273	9561		9524	16384	12433	3950	4117		3872	4646	2323	2323
151547	115	77200		51135	21029	14766	6262	9553		9516	16384	12443	3940	4089		3844	4645	2323	2322
152548	115	76891		51147	21064	14787	6276	9565		9528	16384	12447	3936	4089		3844	4680	2340	2340
153560	116	76945		51159	21029	14777	6251	9557		9520	16384	12454	3929	4109		3864	4645	2323	2322
154563	116	75676		49605	21030	14788	6241	9561		9524	16384	12465	3918	4081		3836	4646	2323	2323
155578	117	76173		50390	21030	14780	6249	9549		9512	16384	12457	3926	4113		3868	4646	2323	2323
156580	118	76126		50354	20997	14749	6247	9545		9508	16384	12442	3941	4081		3836	4613	2307	2306
157595	118	76429		50358	20997	14740	6256	9569		9532	16384	12433	3950	4061		3816	4613	2307	2306
158607	119	76503		50342	20997	14740	6256	9561		9524	16384	12433	3950	4053		3808	4613	2307	2306
159609	120	76455		50406	21036	14771	6264	9565		9528	16384	12445	3938	4113		3868	4652	2326	2326
160622	121	76628		50386	21101	14813	6287	9545		9508	16384	12454	3929	4113		3868	4717	2359	2358
161634	121	76925		51139	21037	14750	6286	9557		9520	16384	12423	3960	4089		3844	4653	2327	2326
162651	122	75559		49585	21029	14758	6270	9557		9520	16384	12435	3948	4065		3820	4645	2323	2322
163650	122	76499		50374	21030	14761	6268	9569		9532	16384	12438	3945	4077		3832	4646	2323	2323
164654	123	76126		50386	21061	14783	6277	9565		9528	16384	12444	3939	4093		3848	4677	2339	2338
165668	123	77171		51135	21029	14744	6284	9545		9508	16384	12421	3962	4097		3852	4645	2323	2322
166679	124	76092		50390	21029	14757	6271	9557		9520	16384	12434	3949	4105		3860	4645	2323	2322
167683	125	75367		49613	21029	14756	6272	9561		9524	16384	12433	3950	4089		3844	4645	2323	2322
168699	126	75704		49669	21030	14747	6282	9569		9532	16384	12424	3959	4137		3892	4646	2323	2323
169700	126	77246		51131	21029	14746	6282	9557		9520	16384	12423	3960	4081		3836	4645	2323	2322
170706	127	76897		51147	20997	14739	6257	9557		9520	16384	12432	3951	4097		3852	4613	2307	2306
171720	128	76387		50350	20997	14733	6263	9565		9528	16384	12426	3957	4057		3812	4613	2307	2306
172734	128	76662		50402	21036	14776	6259	9564		9528	16384	12450	3933	4109		3864	4652	2326	2326
173735	129	76322		50370	21037	14782	6254	9548		9512	16384	12455	3928	4093		3848	4653	2327	2326
174737	130	75362		49621	21036	14504	6531	9556		9520	16384	12178	4205	4101		3856	4652	2326	2326
175743	131	76425		50406	21062	14573	6488	9576		9540	16384	12234	4149	4101		3856	4678	2339	2339
176758	131	76115		50430	21030	14589	6440	9592		9556	16384	12266	4117	4106		3864	4646	2323	2323
177772	132	75351		49641	21030	14596	6433	9568		9532	16384	12273	4110	4106		3864	4646	2323	2323
178773	133	75358		49653	21030	14566	6463	9580		9544	16384	12243	4140	4106		3864	4646	2323	2323
179788	134	75660		49661	21032	14532	6499	9584		9548	16384	12208	4175	4110		3868	4648	2324	2324
180801	134	75457		49657	21030	14536	6493	9568		9532	16384	12213	4170	4122		3880	4646	2323	2323
181804	135	76793		51159	20998	14507	6490	9559		9524	16384	12200	4183	4102		3860	4614	2307	2307
182811	136	76267		50350	21030	14497	6532	9555		9520	16384	12174	4209	4062		3820	4646	2323	2323
183813	136	75614		50314	20998	14487	6510	9559		9524	16384	12180	4203	4022		3780	4614	2307	2307
184828	136	77013		51079	20998	14498	6499	9567		9532	16384	12191	4192	4013		3772	4614	2307	2307
185843	137	75944		50366	21062	14538	6523	9567		9532	16384	12199	4184	4065		3824	4678	2339	2339
186855	137	76391		51155	20999	14542	6456	9579		9544	16384	12234	4149	4077		3836	4615	2308	2307
187857	138	76406		51159	21030	14539	6490	9579		9544	16384	12216	4167	4077		3840	4646	2323	2323
188867	138	74375		49609	20998	14526	6471	9583		9548	16384	12219	4164	4048		3816	4614	2307	2307
189871	138	76254		51115	20998	14488	6509	9559		9524	16384	12181	4202	4048		3816	4614	2307	2307
190875	139	74382		49625	20998	14530	6467	9579		9544	16384	12223	4160	4068		3836	4614	2307	2307
191874	139	75457		50410	20999	14498	6500	9583		9548	16384	12190	4193	4084		3852	4615	2308	2307
192880	140	74400		49637	20998	14501	6496	9583		9548	16384	12194	4189	4076		3844	4614	2307	2307
193893	141	75126		50410	20998	14510	6487	9579		9544	16384	12203	4180	4088		3856	4614	2307	2307
194907	142	75436		50386	20998	14488	6509	9567		9532	16384	12181	4202	4076		3844	4614	2307	2307
195915	142	75532		50402	20999	14500	6498	9563		9528	16384	12192	4191	4096		3864	4615	2308	2307
196918	143	75118		50398	20997	14509	6487	9579		9544	16384	12202	4181	4076		3844	4613	2307	2306
197932	144	75953		51183	20999	14513	6485	9587		9552	16384	12205	4178	4088		3856	4615	2308	2307
198947	145	76210		51159	20999	14497	6501	9571		9536	16384	12189	4194	4080		3848	4615	2308	2307
199962	145	76402		51199	21031	14523	6507	9587		9552	16384	12199	4184	4104		3872	4647	2324	2323
200976	146	74755		49689	21069	14592	6476	9591		9556	16384	12249	4134	4120		3888	4685	2343	2342
201988	147	75281		50470	21070	14546	6523	9579		9544	16384	12203	4180	4148		3916	4686	2343	2343
203006	148	76243		51223	21033	14530	6502	9591		9556	16384	12205	4178	4124		3892	4649	2325	2324
204015	148	74812		49713	21031	14542	6488	9579		9544	16384	12218	4165	4156		3924	4647	2324	2323
205028	149	75950		51223	21031	14543	6487	9583		9548	16384	12219	4164	4132		3900	4647	2324	2323
206041	150	75196		50474	21031	14545	6485	9587		9552	16384	12221	4162	4144		3912	4647	2324	2323
207044	150	76323		51219	21031	14550	6480	9579		9544	16384	12226	4157	4132		3900	4647	2324	2323
208052	151	74429		49701	21031	14532	6499	9591		9556	16384	12208	4176	4132		3900	4647	2324	2323
209058	152	75215		50482	20999	14529	6469	9583		9548	16384	12221	4162	4156		3924	4615	2308	2307
210073	153	75428		50414	20999	14520	6478	9587		9552	16384	12212	4171	4084		3852	4615	2308	2307
211088	153	75503		50406	20998	14506	6491	9567		9532	16384	12199	4184	4096		3864	4614	2307	2307
212089	154	75856		51159	20998	14493	6504	9579		9544	16384	12186	4197	4072		3840	4614	2307	2307
213102	155	75371		50454	21035	14544	6490	9595		9560	16384	12218	4165	4116		3884	4651	2326	2325
214115	155	75668		50462	21037	14550	6486	9591		9556	16384	12223	4160	4128		3896	4653	2327	2326
215127	156	75961		51239	21102	14592	6509	9591		9556	16384	12233	4150	4140		3908	4718	2359	2359
216129	157	75450		50454	21031	14538	6492	9579		9544	16384	12214	4169	4132		3900	4647	2324	2323
217135	157	75145		50490	21031	14540	6490	9583		9548	16384	12216	4167	4164		3932	4647	2324	2323
218138	158	74745		50458	21031	14549	6481	9575		9540	16384	12225	4158	4140		3908	4647	2324	2323
219153	159	74758		50486	21031	14555	6475	9595		9560	16384	12231	4152	4148		3916	4647	2324	2323
220153	160	75810		51235	21031	14529	6501	9579		9544	16384	12205	4178	4148		3916	4647	2324	2323
221166	160	74366		49721	21031	14537	6493	9583		9548	16384	12213	4170	4160		3928	4647	2324	2323
222178	161	74734		50426	20998	14497	6500	9591		9556	16384	12190	4193	4092		3860	4614	2307	2307
223192	162	72953		49661	20999	14533	6465	9591		9556	16384	12225	4158	4092		3860	4615	2308	2307
224207	163	73675		50426	20998	14521	6476	9591		9556	16384	12214	4169	4092		3860	4614	2307	2307
225223	164	73242		49673	21031	14515	6515	9591		9556	16384	12191	4192	4104		3872	4647	2324	2323
226227	164	74768		51259	21034	14521	6512	9587		9552	16384	12196	4187	4164		3932	4650	2325	2325
227233	165	74700		51255	21070	14550	6519	9599		9564	16384	12207	4176	4148		3916	4686	2343	2343
228234	166	74895		51231	21036	14535	6500	9599		9564	16384	12209	4174	4124		3892	4652	2326	2326
229240	166	73462		49721	21031	14500	6530	9603		9568	16384	12176	4207	4140		3908	4647	2324	2323
230252	167	73868		50494	21031	14476	6554	9591		9556	16384	12152	4231	4160		3928	4647	2324	2323
231256	168	74606		51235	21031	14451	6579	9579		9544	16384	12127	4256	4148		3916	4647	2324	2323
232259	168	74154		50490	21031	14487	6543	9599		9564	16384	12163	4220	4148		3916	4647	2324	2323
233270	169	75011		51271	21032	14494	6537	9587		9552	16384	12170	4213	4176		3944	4648	2324	2324
234276	170	74552		51215	20999	14455	6543	9595		9560	16384	12147	4236	4112		3880	4615	2308	2307
235276	171	73006		49641	20999	14435	6563	9571		9536	16384	12127	4256	4092		3860	4615	2308	2307
236291	171	74076		50414	20999	14469	6530	9583		9548	16384	12161	4223	4088		3856	4615	2308	2307
237306	172	74169		50434	20999	14446	6552	9587		9552	16384	12138	4245	4104		3872	4615	2308	2307
238309	173	73805		50430	20999	14439	6561	9591		9556	16384	12131	4254	4096		3864	4615	2308	2307
239323	174	74102		50442	21068	14493	6574	9583		9548	16384	12151	4232	4116		3884	4684	2342	2342
240337	174	73528		49705	21038	14460	6577	9583		9548	16384	12133	4250	4144		3912	4654	2327	2327
241340	175	73860		50470	21036	14462	6573	9587		9552	16384	12136	4247	4140		3908	4652	2326	2326
242343	176	74946		51267	21031	14472	6558	9595		9560	16384	12148	4235	4164		3932	4647	2324	2323
243358	176	74210		50450	21031	14475	6555	9571		9536	16384	12151	4232	4136		3904	4647	2324	2323
244372	177	74587		51235	21063	14461	6601	9583		9548	16384	12121	4262	4144		3912	4679	2340	2339
245385	178	74637		51239	21031	14458	6572	9591		9556	16384	12134	4249	4140		3908	4647	2324	2323
246386	179	74914		51271	21031	14465	6565	9595		9560	16384	12141	4242	4168		3936	4647	2324	2323
247390	179	73772		50430	21063	14486	6576	9575		9540	16384	12146	4237	4112		3880	4679	2340	2339
248406	180	73792		50438	20999	14438	6560	9583		9548	16384	12130	4253	4112		3880	4615	2308	2307
249420	180	73295		49653	20999	14452	6546	9579		9544	16384	12144	4239	4096		3864	4615	2308	2307
250434	181	73023		49661	20999	14431	6567	9583		9548	16384	12123	4260	4100		3868	4615	2308	2307
251443	182	73948		50430	21031	14473	6557	9567		9532	16384	12149	4234	4120		3888	4647	2324	2323
252458	183	74761		51243	21038	14454	6583	9587		9552	16384	12127	4256	4148		3916	4654	2327	2327
253470	183	75028		51255	21038	14441	6596	9587		9552	16384	12114	4269	4160		3928	4654	2327	2327
254482	184	73710		50470	21034	14446	6587	9587		9552	16384	12121	4262	4140		3908	4650	2325	2325
255484	185	73714		50478	21031	14471	6559	9575		9540	16384	12147	4236	4160		3928	4647	2324	2323
256498	185	73292		49713	21063	14503	6559	9575		9540	16384	12163	4220	4160		3928	4679	2340	2339
257514	186	73755		50478	21031	14460	6570	9583		9548	16384	12136	4247	4152		3920	4647	2324	2323
258520	187	73760		50486	21031	14477	6553	9587		9552	16384	12153	4230	4156		3924	4647	2324	2323
259523	188	73778		50494	21031	14447	6583	9579		9544	16384	12123	4260	4172		3940	4647	2324	2323
260528	188	74784		51223	20999	14438	6560	9579		9544	16384	12130	4253	4136		3904	4615	2308	2307
261541	189	74837		51199	20999	14439	6559	9587		9552	16384	12131	4252	4104		3872	4615	2308	2307
262543	190	74466		51191	20999	14452	6546	9587		9552	16384	12144	4239	4096		3864	4615	2308	2307
263556	191	73693		50422	20998	14442	6555	9567		9532	16384	12135	4248	4112		3880	4614	2307	2307
264559	191	74217		50426	21033	14458	6574	9575		9540	16384	12133	4250	4108		3876	4649	2325	2324
265570	192	73916		50478	21039	14465	6573	9583		9548	16384	12137	4246	4152		3920	4655	2328	2327
266579	193	74629		51239	21038	14474	6563	9587		9552	16384	12147	4236	4144		3912	4654	2327	2327
267595	193	74190		50478	21032	14447	6584	9575		9540	16384	12123	4260	4160		3928	4648	2324	2324
268596	194	73782		50462	21031	14455	6575	9575		9540	16384	12131	4252	4144		3912	4647	2324	2323
269599	195	73318		49681	21064	14470	6593	9583		9548	16384	12130	4253	4120		3888	4680	2340	2340
270604	195	74106		50462	21031	14449	6581	9571		9536	16384	12125	4258	4148		3916	4647	2324	2323
271620	196	74204		50482	21031	14461	6569	9574		9540	16384	12137	4246	4164		3932	4647	2324	2323
272636	197	73794		50494	21031	14451	6579	9578		9544	16384	12127	4256	4172		3940	4647	2324	2323
273639	198	73797		50454	20999	14438	6560	9578		9544	16384	12130	4253	4132		3900	4615	2308	2307
274652	198	73267		49665	20999	14434	6564	9590		9556	16384	12126	4257	4096		3864	4615	2308	2307
275654	199	72899		49657	20999	14450	6548	9582		9548	16384	12142	4241	4096		3864	4615	2308	2307
276658	200	74682		51187	21031	14471	6559	9578		9544	16384	12147	4236	4100		3868	4647	2324	2323
277666	200	74343		51167	20999	14419	6579	9578		9544	16384	12111	4272	4079		3848	4615	2308	2307
278676	200	74480		51151	21031	14428	6602	9586		9552	16384	12104	4279	4055		3824	4647	2324	2323
279678	201	74613		51147	20999	14422	6576	9582		9548	16384	12114	4269	4055		3824	4615	2308	2307
280696	201	74349		51151	21031	14423	6607	9570		9536	16384	12099	4284	4071		3840	4647	2324	2323
281700	202	74477		51203	21066	14467	6598	9577		9544	16384	12126	4257	4115		3884	4682	2341	2341
282702	202	73398		50442	21063	14472	6590	9581		9548	16384	12132	4251	4115		3884	4679	2340	2339
283704	202	74195		51171	21031	14479	6551	9561		9528	16384	12139	4244	4099		3868	4647	2340	2307
284716	203	73019		49709	21031	14431	6599	9585		9552	16384	12107	4276	4142		3912	4647	2324	2323
285719	203	73446		50442	21031	14441	6589	9585		9552	16384	12117	4266	4110		3880	4647	2324	2323
286719	204	70607		47158	21034	14346	6687	9589		9556	16384	12005	4378	4046		3816	4650	2341	2309
287736	204	70978		46970	21040	14020	7019	9581		9548	16384	11692	4691	4058		3828	4656	2328	2328
288746	205	70494		46906	20972	13984	6987	9585		9552	16384	11690	4693	3990		3760	4588	2294	2294
289759	206	70337		46870	20969	13982	6986	9577		9544	16384	11689	4694	3962		3732	4585	2293	2292
290776	207	70466		46866	20969	13982	6986	9577		9544	16384	11689	4694	3958		3728	4585	2293	2292
291789	207	47549		23608	20969	13685	7283	9405		9372	16384	11392	4991	3970		3740	4585	2293	2292
292791	208	46972		23464	20968	13670	7297	9349		9316	16384	11378	5005	3954		3724	4584	2292	2292
293793	209	46708		23464	20968	13668	7299	9349		9316	16384	11376	5007	3954		3724	4584	2292	2292
294806	210	46750		23484	20969	13668	7300	9349		9316	16384	11375	5008	3974		3744	4585	2293	2292
295818	211	47278		23472	20968	13650	7317	9349		9316	16384	11358	5025	3962		3732	4584	2292	2292
296825	212	47156		23472	20968	13652	7315	9349		9316	16384	11360	5023	3962		3732	4584	2292	2292
297826	213	47023		23488	20969	13653	7315	9349		9316	16384	11360	5023	3978		3748	4585	2293	2292
298830	213	47042		23468	20969	13606	7362	9345		9312	16384	11313	5070	3962		3732	4585	2293	2292
299846	214	47362		23468	20969	13552	7416	9345		9312	16384	11259	5124	3962		3732	4585	2293	2292
300861	215	47167		23472	20969	13552	7416	9345		9312	16384	11259	5124	3966		3736	4585	2293	2292
301866	216	47169		23484	20969	13552	7416	9345		9312	16384	11259	5124	3978		3748	4585	2293	2292
302880	217	46081		23472	20969	13552	7416	9345		9312	16384	11259	5124	3966		3736	4585	2293	2292
303885	218	45927		23464	20969	13552	7416	9345		9312	16384	11259	5124	3958		3728	4585	2293	2292
304891	219	45944		23476	20969	13552	7416	9345		9312	16384	11259	5124	3971		3740	4585	2293	2292
305905	220	45526		23464	20969	13552	7416	9345		9312	16384	11259	5124	3958		3728	4585	2293	2292
306909	221	45762		23468	20969	13552	7416	9345		9312	16384	11259	5124	3962		3732	4585	2293	2292
307910	222	45621		23468	20969	13551	7417	9345		9312	16384	11258	5125	3962		3732	4585	2293	2292
308919	223	45848		23472	20969	13568	7400	9344		9312	16384	11259	5124	3966		3736	4585	2309	2276
309931	223	45784		23464	20969	13552	7416	9344		9312	16384	11259	5124	3957		3728	4585	2293	2292
310947	224	45547		23472	20969	13551	7417	9344		9312	16384	11258	5125	3965		3736	4585	2293	2292
311950	224	45898		23472	20969	13551	7417	9344		9312	16384	11258	5125	3965		3736	4585	2293	2292
312965	225	45329		23472	20969	13552	7416	9344		9312	16384	11259	5124	3965		3736	4585	2293	2292
313980	226	45420		23484	20969	13552	7416	9345		9312	16384	11259	5124	3982		3748	4585	2293	2292
314994	227	45846		23464	20969	13551	7417	9345		9312	16384	11258	5125	3965		3728	4585	2293	2292
315996	228	45767		23464	21001	13568	7432	9345		9312	16384	11259	5124	3965		3728	4617	2309	2308
316997	229	45663		23472	20969	13552	7416	9345		9312	16384	11259	5124	3973		3736	4585	2293	2292
318000	230	45815		23464	20969	13551	7417	9345		9312	16384	11258	5125	3965		3728	4585	2293	2292
319006	231	45814		23468	20969	13552	7416	9345		9312	16384	11259	5124	3969		3732	4585	2293	2292
320007	232	45685		23464	20969	13552	7416	9345		9312	16384	11259	5124	3965		3728	4585	2293	2292
321020	233	45694		23480	20969	13551	7417	9345		9312	16384	11258	5125	3981		3744	4585	2293	2292
322025	234	45917		23316	20969	13552	7416	9189		9156	16384	11259	5124	3974		3736	4585	2293	2292
323039	235	45810		23312	20969	13553	7415	9189		9156	16384	11260	5123	3970		3732	4585	2293	2292
324055	236	45659		23324	21001	13568	7432	9189		9156	16384	11259	5124	3981		3744	4617	2309	2308
325070	237	45942		23316	20969	13552	7416	9189		9156	16384	11259	5124	3973		3736	4585	2293	2292
326086	238	46250		23308	20969	13553	7415	9189		9156	16384	11260	5123	3964		3728	4585	2293	2292
327090	239	45992		23308	20969	13552	7416	9189		9156	16384	11259	5124	3964		3728	4585	2293	2292
328096	240	46001		23320	20969	13552	7416	9189		9156	16384	11259	5124	3976		3740	4585	2293	2292
329108	240	46363		23308	20969	13553	7415	9187		9156	16384	11260	5123	3964		3728	4585	2293	2292
330110	241	46193		23308	20969	13551	7417	9187		9156	16384	11258	5125	3964		3728	4585	2293	2292
331126	242	45965		23324	20969	13552	7416	9187		9156	16384	11259	5124	3980		3744	4585	2293	2292
332127	243	45891		23308	20969	13553	7415	9187		9156	16384	11260	5123	3965		3728	4585	2293	2292
333131	244	45853		23308	20969	13551	7417	9186		9156	16384	11258	5125	3965		3728	4585	2293	2292
334146	245	45734		23308	20969	13552	7416	9189		9156	16384	11259	5124	3965		3728	4585	2293	2292
335161	246	45922		23328	20969	13553	7415	9189		9156	16384	11260	5123	3987		3748	4585	2293	2292
336164	247	46330		23316	20969	13551	7417	9189		9156	16384	11258	5125	3975		3736	4585	2293	2292
337178	248	46402		23308	20969	13552	7416	9189		9156	16384	11259	5124	3967		3728	4585	2293	2292
338184	249	46246		23320	20969	13553	7415	9189		9156	16384	11260	5123	3979		3740	4585	2293	2292
339187	250	46172		23308	20969	13552	7416	9189		9156	16384	11259	5124	3967		3728	4585	2293	2292
340188	250	46578		23308	20969	13552	7416	9189		9156	16384	11259	5124	3967		3728	4585	2293	2292
341191	251	46443		23308	20969	13552	7416	9189		9156	16384	11259	5124	3967		3728	4585	2293	2292
342195	252	46448		23320	20970	13553	7416	9189		9156	16384	11260	5123	3979		3740	4586	2293	2293
343198	253	46678		23308	20969	13552	7416	9189		9156	16384	11259	5124	3967		3728	4585	2293	2292
344198	254	46693		23308	20969	13552	7416	9189		9156	16384	11259	5124	3967		3728	4585	2293	2292
345204	255	46110		23324	20970	13553	7416	9189		9156	16384	11260	5123	3983		3744	4586	2293	2293
346219	256	46347		23316	20969	13552	7416	9189		9156	16384	11259	5124	3975		3736	4585	2293	2292
347223	257	46246		23316	20969	13552	7416	9190		9156	16384	11259	5124	3975		3736	4585	2293	2292
348225	258	46167		23320	20970	13553	7416	9190		9156	16384	11260	5123	3979		3740	4586	2293	2293
349227	259	45954		23308	20969	13552	7416	9190		9156	16384	11259	5124	3967		3728	4585	2293	2292
350242	260	45992		23308	20969	13552	7416	9190		9156	16384	11259	5124	3967		3728	4585	2293	2292
351245	261	46411		23328	20970	13554	7415	9190		9156	16384	11261	5122	3987		3748	4586	2293	2293
352251	262	46212		23316	20969	13530	7438	9189		9156	16384	11237	5146	3975		3736	4585	2293	2292
353252	263	45936		23312	20969	13502	7466	9190		9156	16384	11209	5174	3972		3732	4585	2293	2292
354256	264	46165		23320	20970	13447	7522	9189		9156	16384	11154	5229	3979		3740	4586	2293	2293
355260	265	46156		23308	20969	13446	7522	9189		9156	16384	11153	5230	3967		3728	4585	2293	2292
356275	266	45823		23308	20969	13446	7522	9189		9156	16384	11153	5230	3967		3728	4585	2293	2292
357290	267	45836		23308	20969	13447	7521	9189		9156	16384	11154	5229	3967		3728	4585	2293	2292
358303	268	46457		23328	20970	13446	7523	9189		9156	16384	11153	5230	3987		3748	4586	2293	2293
359311	269	46332		23312	21001	13462	7538	9189		9156	16384	11153	5230	3971		3732	4617	2309	2308
360324	269	46135		23316	20969	13448	7520	9193		9160	16384	11155	5228	3971		3732	4585	2293	2292
361325	270	46256		23312	20969	13446	7522	9193		9160	16384	11153	5230	3966		3728	4585	2293	2292
362340	271	46617		23332	20970	13438	7531	9193		9160	16384	11145	5238	3986		3748	4586	2293	2293
363351	272	46371		23316	20969	13438	7530	9193		9160	16384	11145	5238	3970		3732	4585	2293	2292
364353	273	46210		23316	20969	13437	7531	9193		9160	16384	11144	5239	3970		3732	4585	2293	2292
365355	274	46298		23308	20970	13430	7539	9189		9156	16384	11137	5246	3966		3728	4586	2293	2293
366361	275	46044		23308	20969	13414	7554	9189		9156	16384	11121	5262	3966		3728	4585	2293	2292
367377	276	45849		23308	20969	13413	7555	9189		9156	16384	11120	5263	3966		3728	4585	2293	2292
368388	277	45800		23308	20969	13413	7555	9189		9156	16384	11120	5263	3966		3728	4585	2293	2292
369391	278	46159		23324	20970	13414	7555	9189		9156	16384	11121	5262	3982		3744	4586	2293	2293
370399	279	46016		23308	20969	13413	7555	9189		9156	16384	11120	5263	3966		3728	4585	2293	2292
371402	280	45941		23316	20969	13413	7555	9189		9156	16384	11120	5263	3974		3736	4585	2293	2292
372405	281	46105		23324	20970	13414	7555	9189		9156	16384	11121	5262	3982		3744	4586	2293	2293
373407	282	45951		23316	20969	13413	7555	9189		9156	16384	11120	5263	3974		3736	4585	2293	2292
374411	283	45817		23312	20969	13413	7555	9189		9156	16384	11120	5263	3970		3732	4585	2293	2292
375424	284	45770		23320	20970	13414	7555	9189		9156	16384	11121	5262	3978		3740	4586	2293	2293
376426	285	46330		23312	20969	13413	7555	9189		9156	16384	11120	5263	3970		3732	4585	2293	2292
377441	286	46201		23312	20969	13413	7555	9189		9156	16384	11120	5263	3970		3732	4585	2293	2292
378444	287	46367		23336	20970	13415	7554	9189		9156	16384	11122	5261	3991		3752	4586	2293	2293
379455	288	46614		23344	20969	13563	7405	9201		9168	16384	11270	5113	3982		3744	4585	2293	2292
380456	289	46506		23340	20969	13564	7404	9201		9168	16384	11271	5112	3978		3740	4585	2293	2292
381457	289	46348		23336	20969	13564	7404	9201		9168	16384	11271	5112	3974		3736	4585	2293	2292
382460	290	46298		23352	20970	13564	7405	9201		9168	16384	11271	5112	3990		3752	4586	2293	2293
383464	291	46682		23344	20969	13563	7405	9201		9168	16384	11270	5113	3982		3744	4585	2293	2292
384471	292	46455		23344	20969	13564	7404	9201		9168	16384	11271	5112	3982		3744	4585	2293	2292
385474	293	46326		23344	20969	13564	7404	9201		9168	16384	11271	5112	3982		3744	4585	2293	2292
386476	294	46692		23356	20970	13563	7406	9201		9168	16384	11270	5113	3994		3756	4586	2293	2293
387479	295	46507		23336	20969	13564	7404	9201		9168	16384	11271	5112	3974		3736	4585	2293	2292
388481	296	46318		23344	20969	13564	7404	9201		9168	16384	11271	5112	3982		3744	4585	2293	2292
389486	297	46700		23356	20970	13564	7405	9201		9168	16384	11271	5112	3995		3756	4586	2293	2293
390491	298	46694		23344	20969	13564	7404	9201		9168	16384	11271	5112	3983		3744	4585	2293	2292
391506	299	46322		23344	21001	13580	7420	9201		9168	16384	11271	5112	3983		3744	4617	2309	2308
392508	300	46347		23364	20970	13562	7407	9201		9168	16384	11269	5114	4003		3764	4586	2293	2293
393522	301	46688		23336	20969	13564	7404	9201		9168	16384	11271	5112	3975		3736	4585	2293	2292
394536	302	46403		23336	20969	13563	7405	9201		9168	16384	11270	5113	3975		3736	4585	2293	2292
395551	303	46257		23356	20970	13562	7407	9201		9168	16384	11269	5114	3995		3756	4586	2293	2293
396566	304	46616		23344	20969	13563	7405	9201		9168	16384	11270	5113	3983		3744	4585	2293	2292
397579	305	46587		23344	20969	13564	7404	9201		9168	16384	11271	5112	3983		3744	4585	2293	2292
398582	306	46259		23348	20970	13562	7407	9201		9168	16384	11269	5114	3987		3748	4586	2293	2293
399586	307	45954		23336	20969	13563	7405	9201		9168	16384	11270	5113	3975		3736	4585	2293	2292
400598	308	46265		23336	20969	13564	7404	9199		9168	16384	11271	5112	3975		3736	4585	2293	2292
401602	309	46593		23348	20970	13562	7407	9199		9168	16384	11269	5114	3986		3748	4586	2293	2293
402614	310	45896		23332	20969	13563	7405	9199		9168	16384	11270	5113	3970		3732	4585	2293	2292
403631	311	45972		23336	20969	13564	7404	9199		9168	16384	11271	5112	3974		3736	4585	2293	2292
404647	311	45777		23336	20969	13563	7405	9199		9168	16384	11270	5113	3974		3736	4585	2293	2292
405652	312	45739		23348	20970	13563	7406	9201		9168	16384	11270	5113	3986		3748	4586	2293	2293
406665	313	45666		23340	20969	13564	7404	9201		9168	16384	11271	5112	3978		3740	4585	2293	2292
407676	314	45696		23340	20969	13563	7405	9201		9168	16384	11270	5113	3981		3740	4585	2293	2292
408679	315	45897		23348	20970	13564	7405	9201		9168	16384	11271	5112	3989		3748	4586	2293	2293
409683	316	45774		23336	20969	13564	7404	9201		9168	16384	11271	5112	3977		3736	4585	2293	2292
410696	316	45792		23336	20969	13563	7405	9201		9168	16384	11270	5113	3977		3736	4585	2293	2292
411700	317	46002		23336	20969	13564	7404	9201		9168	16384	11271	5112	3975		3736	4585	2293	2292
412715	317	45557		23336	20969	13564	7404	9202		9168	16384	11271	5112	3977		3736	4585	2293	2292
413720	317	45972		23348	20970	13564	7405	9202		9168	16384	11271	5112	3990		3748	4586	2293	2293
414736	318	45959		23336	20969	13564	7404	9202		9168	16384	11271	5112	3978		3736	4585	2293	2292
415752	319	45573		23336	20969	13564	7404	9202		9168	16384	11271	5112	3978		3736	4585	2293	2292
416766	320	45579		23336	20969	13564	7404	9202		9168	16384	11271	5112	3978		3736	4585	2293	2292
417772	321	45597		23336	20969	13563	7405	9202		9168	16384	11270	5113	3978		3736	4585	2293	2292
418788	322	45821		23356	20970	13565	7404	9202		9168	16384	11272	5111	3996		3756	4586	2293	2293
419801	323	45971		23336	20969	13565	7403	9202		9168	16384	11272	5111	3975		3736	4585	2293	2292
420815	323	45950		23336	20969	13564	7404	9202		9168	16384	11271	5112	3976		3736	4585	2293	2292
421816	324	45912		23336	20969	13564	7404	9202		9168	16384	11271	5112	3979		3736	4585	2293	2292
422818	325	45875		23336	20970	13565	7404	9202		9168	16384	11272	5111	3979		3736	4586	2293	2293
423819	326	45876		23340	20969	13564	7404	9202		9168	16384	11271	5112	3983		3740	4585	2293	2292
424839	327	45864		23336	20969	13564	7404	9202		9168	16384	11271	5112	3979		3736	4585	2293	2292
425855	328	45877		23344	20970	13564	7405	9202		9168	16384	11271	5112	3987		3744	4586	2293	2293
426857	329	45857		23336	20969	13564	7404	9203		9168	16384	11271	5112	3980		3736	4585	2293	2292
427860	330	46538		23348	20969	13564	7404	9203		9168	16384	11271	5112	3992		3748	4585	2293	2292
428876	331	46369		23344	20969	13564	7404	9203		9168	16384	11271	5112	3988		3744	4585	2293	2292
429879	332	46238		23360	20970	13564	7405	9203		9168	16384	11271	5112	4004		3760	4586	2293	2293
430895	333	46528		23340	20969	13563	7405	9203		9168	16384	11270	5113	3984		3740	4585	2293	2292
431898	333	46515		23340	20969	13563	7405	9203		9168	16384	11270	5113	3984		3740	4585	2293	2292
432904	334	46342		23352	20970	13564	7405	9203		9168	16384	11271	5112	3996		3752	4586	2293	2293
433910	335	46269		23340	20969	13563	7405	9203		9168	16384	11270	5113	3984		3740	4585	2293	2292
434920	336	46549		23340	20969	13563	7405	9203		9168	16384	11270	5113	3984		3740	4585	2293	2292
435923	337	45907		23348	20970	13564	7405	9203		9168	16384	11271	5112	3992		3748	4586	2293	2293
436935	338	45804		23348	20969	13564	7404	9203		9168	16384	11271	5112	3992		3748	4585	2293	2292
437946	339	45745		23344	20969	13564	7404	9203		9168	16384	11271	5112	3988		3744	4585	2293	2292
438949	340	46111		23356	20970	13564	7405	9203		9168	16384	11271	5112	4000		3756	4586	2293	2293
439960	341	45958		23344	20969	13564	7404	9202		9168	16384	11271	5112	3987		3744	4585	2293	2292
440962	342	45763		23344	20969	13564	7404	9203		9168	16384	11271	5112	3990		3744	4585	2293	2292
441961	343	46212		23336	20969	13564	7404	9203		9168	16384	11271	5112	3978		3736	4585	2293	2292
442972	343	46029		23348	20970	13580	7389	9203		9168	16384	11271	5112	3994		3748	4586	2309	2277
443980	344	45808		23336	20969	13580	7388	9203		9168	16384	11271	5112	3982		3736	4585	2309	2276
444984	345	46237		23336	20969	13564	7404	9204		9168	16384	11271	5112	3984		3736	4585	2293	2292
445999	345	45789		23344	20969	13562	7406	9204		9168	16384	11269	5114	3992		3744	4585	2293	2292
447002	346	46101		23336	20969	13580	7388	9204		9168	16384	11271	5112	3983		3736	4585	2309	2276
448016	346	46230		23340	20969	13564	7404	9205		9168	16384	11271	5112	3990		3740	4585	2293	2292
449019	347	46228		23336	20969	13564	7404	9204		9168	16384	11271	5112	3986		3736	4585	2293	2292
450030	348	46100		23336	20969	13578	7390	9204		9168	16384	11269	5114	3985		3736	4585	2309	2276
451033	349	46566		23336	20969	13564	7404	9205		9168	16384	11271	5112	3984		3736	4585	2293	2292
452036	349	46179		23336	20969	13580	7388	9206		9168	16384	11271	5112	3986		3736	4585	2309	2276
453052	350	46313		23336	20969	13564	7404	9206		9168	16384	11271	5112	3986		3736	4585	2293	2292
454061	350	46723		23352	20970	13580	7389	9207		9168	16384	11271	5112	4003		3752	4586	2309	2277
455063	351	46287		23348	20969	13564	7404	9207		9168	16384	11271	5112	3999		3748	4585	2293	2292
456078	352	46248		23348	20969	13564	7404	9207		9168	16384	11271	5112	3999		3748	4585	2293	2292
457080	353	46242		23348	20970	13564	7405	9207		9168	16384	11271	5112	3999		3748	4586	2293	2293
458086	354	46258		23336	20969	13564	7404	9207		9168	16384	11271	5112	3987		3736	4585	2293	2292
459099	355	46257		23336	20969	13564	7404	9207		9168	16384	11271	5112	3987		3736	4585	2293	2292
460103	356	46260		23348	20970	13564	7405	9207		9168	16384	11271	5112	3999		3748	4586	2293	2293
461119	357	46391		23336	20969	13564	7404	9207		9168	16384	11271	5112	3987		3736	4585	2293	2292
462133	358	46992		23340	21002	13580	7421	9207		9168	16384	11271	5112	3991		3740	4618	2309	2309
463136	359	46998		23340	21001	13596	7404	9208		9168	16384	11271	5112	3991		3740	4617	2325	2292
464141	359	46585		23348	20969	13564	7404	9212		9172	16384	11271	5112	3995		3744	4585	2293	2292
465150	360	46476		23344	21001	13580	7420	9212		9172	16384	11271	5112	3991		3740	4617	2309	2308
466157	361	46825		23348	20970	13565	7404	9212		9172	16384	11272	5111	3995		3744	4586	2293	2293
467160	362	46663		23340	20969	13565	7403	9212		9172	16384	11272	5111	3987		3736	4585	2293	2292
468166	363	46517		23340	20969	13565	7403	9212		9172	16384	11272	5111	3987		3736	4585	2293	2292
469169	364	47127		23356	20970	13565	7404	9212		9172	16384	11272	5111	4003		3752	4586	2293	2293
470171	365	47042		23340	20969	13565	7403	9212		9172	16384	11272	5111	3987		3736	4585	2293	2292
471174	365	46846		23340	20969	13565	7403	9212		9172	16384	11272	5111	3987		3736	4585	2293	2292
472188	366	46442		23340	20970	13565	7404	9212		9172	16384	11272	5111	3987		3736	4586	2293	2293
473189	367	46460		23344	20969	13564	7404	9211		9172	16384	11271	5112	3991		3740	4585	2293	2292
474198	368	46382		23340	20969	13564	7404	9211		9172	16384	11271	5112	3987		3736	4585	2293	2292
475199	369	46715		23340	20969	13563	7405	9211		9172	16384	11270	5113	3987		3736	4585	2293	2292
476205	369	46725		23352	20970	13564	7405	9211		9172	16384	11271	5112	3999		3748	4586	2293	2293
477208	370	46669		23340	20969	13564	7404	9211		9172	16384	11271	5112	3987		3736	4585	2293	2292
478213	371	46908		23340	20969	13563	7405	9211		9172	16384	11270	5113	3983		3736	4585	2293	2292
479214	372	47060		23356	20970	13564	7405	9211		9172	16384	11271	5112	3999		3752	4586	2293	2293
480230	373	46412		23340	20969	13564	7404	9211		9172	16384	11271	5112	3983		3736	4585	2293	2292
481244	374	46157		23376	20970	13600	7369	9223		9184	16384	11307	5076	3994		3748	4586	2293	2293
482246	375	46371		23384	20970	13601	7368	9223		9184	16384	11308	5075	4002		3756	4586	2293	2293
483248	375	46633		23372	20970	13601	7368	9223		9184	16384	11308	5075	3990		3744	4586	2293	2293
484261	376	46462		23372	20970	13600	7369	9223		9184	16384	11307	5076	3990		3744	4586	2293	2293
485265	377	46388		23364	20970	13601	7368	9223		9184	16384	11308	5075	3982		3736	4586	2293	2293
486267	378	46015		23368	20970	13601	7368	9214		9176	16384	11308	5075	3994		3748	4586	2293	2293
487271	379	46104		23356	20970	13615	7354	9214		9176	16384	11306	5077	3982		3736	4586	2309	2277
488288	379	46270		23356	20970	13601	7368	9214		9176	16384	11308	5075	3982		3736	4586	2293	2293
489300	380	46144		23360	20970	13601	7368	9214		9176	16384	11308	5075	3987		3740	4586	2293	2293
490315	381	46146		23248	20970	13600	7369	9190		9152	16384	11307	5076	3999		3752	4586	2293	2293
491330	382	46085		23232	20970	13599	7370	9190		9152	16384	11306	5077	3983		3736	4586	2293	2293
492343	383	46486		23232	20970	13601	7368	9190		9152	16384	11308	5075	3983		3736	4586	2293	2293
493345	384	46305		23040	20970	13600	7369	9190		9152	16384	11307	5076	4003		3756	4586	2293	2293
494361	385	45865		22616	20970	13599	7370	8978		8940	16384	11306	5077	3983		3736	4586	2293	2293
495362	386	46117		22528	20970	13600	7369	8918		8880	16384	11307	5076	3967		3720	4586	2293	2293
496368	387	46145		22544	20971	13601	7369	8918		8880	16384	11307	5076	3983		3736	4587	2294	2293
497382	388	46130		22528	20970	13601	7368	8918		8880	16384	11308	5075	3967		3720	4586	2293	2293
498386	389	46124		22528	20970	13601	7368	8918		8880	16384	11308	5075	3967		3720	4586	2293	2293
499403	390	46378		22540	20971	13601	7369	8918		8880	16384	11307	5076	3979		3732	4587	2294	2293
500403	391	46231		22524	20970	13600	7369	8914		8876	16384	11307	5076	3967		3720	4586	2293	2293
501420	392	46122		22524	20970	13601	7368	8914		8876	16384	11308	5075	3967		3720	4586	2293	2293
502435	392	46498		21756	20971	13601	7369	8198		8160	16384	11307	5076	3975		3728	4587	2294	2293
503447	393	46364		21744	20970	13599	7370	8198		8160	16384	11306	5077	3963		3716	4586	2293	2293
504466	394	46135		21748	20970	13601	7368	8198		8160	16384	11308	5075	3967		3720	4586	2293	2293
505473	395	46137		21760	20971	13598	7372	8198		8160	16384	11304	5079	3979		3732	4587	2294	2293
506482	396	46484		21428	20970	13592	7377	7934		7896	16384	11299	5084	3967		3720	4586	2293	2293
507495	397	46130		21428	20970	13592	7377	7934		7896	16384	11299	5084	3967		3720	4586	2293	2293
508499	398	45892		21428	20970	13592	7377	7934		7896	16384	11299	5084	3967		3720	4586	2293	2293
509506	399	46088		21440	20971	13592	7378	7934		7896	16384	11298	5085	3979		3732	4587	2294	2293
510512	400	45985		21428	20970	13592	7377	7934		7896	16384	11299	5084	3967		3720	4586	2293	2293
511513	401	45781		21432	20970	13592	7377	7934		7896	16384	11299	5084	3971		3724	4586	2293	2293
512519	402	45737		21444	20971	13592	7378	7934		7896	16384	11298	5085	3983		3736	4587	2294	2293
513534	403	46089		21424	20970	13592	7377	7934		7896	16384	11299	5084	3963		3716	4586	2293	2293
514538	404	45986		21424	20970	13592	7377	7934		7896	16384	11299	5084	3963		3716	4586	2293	2293
515553	405	45807		21452	20972	13593	7378	7934		7896	16384	11299	5084	3991		3744	4588	2294	2294
516559	406	46175		21316	20971	13742	7228	7826		7788	16384	11448	4935	3959		3712	4587	2294	2293
517573	407	46354		21320	20972	13743	7228	7826		7788	16384	11449	4934	3963		3716	4588	2294	2294
518578	408	46079		21304	20971	13742	7228	7826		7788	16384	11448	4935	3955		3708	4587	2294	2293
519595	409	46070		21304	20971	13742	7228	7826		7788	16384	11448	4935	3955		3708	4587	2294	2293
520595	410	46366		21308	20971	13742	7228	7826		7788	16384	11448	4935	3959		3712	4587	2294	2293
521601	410	46309		21320	20972	13742	7229	7826		7788	16384	11448	4935	3971		3724	4588	2294	2294
522614	412	46107		21308	20971	13742	7228	7826		7788	16384	11448	4935	3959		3712	4587	2294	2293
523629	413	46360		21304	20971	13743	7227	7826		7788	16384	11449	4934	3955		3708	4587	2294	2293
524631	413	46370		21316	20972	13742	7229	7826		7788	16384	11448	4935	3967		3720	4588	2294	2294
525634	414	46186		21304	20971	13742	7228	7824		7788	16384	11448	4935	3955		3708	4587	2294	2293
526650	415	45914		21312	20971	13743	7227	7824		7788	16384	11449	4934	3960		3716	4587	2294	2293
527655	416	46172		21324	20972	13742	7229	7825		7788	16384	11448	4935	3972		3728	4588	2294	2294
528671	417	45533		21300	20971	13742	7228	7824		7788	16384	11448	4935	3940		3704	4587	2294	2293
529685	418	45582		21300	20971	13743	7227	7824		7788	16384	11449	4934	3940		3704	4587	2294	2293
530687	419	45626		21300	20971	13740	7230	7824		7788	16384	11446	4937	3940		3704	4587	2294	2293
531693	420	45699		21304	20972	13738	7233	7824		7788	16384	11444	4939	3944		3708	4588	2294	2294
532710	420	45699		21300	20971	13737	7233	7824		7788	16384	11443	4940	3940		3704	4587	2294	2293
533724	421	45687		21304	20971	13725	7245	7824		7788	16384	11431	4952	3944		3708	4587	2294	2293
534727	422	45674		21296	20971	13726	7244	7824		7788	16384	11432	4951	3936		3700	4587	2294	2293
535741	423	45692		21312	21004	13743	7260	7824		7788	16384	11433	4950	3952		3716	4620	2310	2310
536742	424	46016		21304	20971	13726	7244	7824		7788	16384	11432	4951	3944		3708	4587	2294	2293
537747	425	46019		21300	21002	13741	7260	7824		7788	16384	11432	4951	3940		3704	4618	2309	2309
538760	426	45588		21324	20972	13726	7245	7824		7788	16384	11432	4951	3964		3728	4588	2294	2294
539762	427	45704		21304	20971	13702	7268	7824		7788	16384	11408	4975	3944		3708	4587	2294	2293
540763	427	45467		21300	20971	13675	7295	7824		7788	16384	11381	5002	3940		3704	4587	2294	2293
541779	427	45655		21300	20972	13619	7352	7824		7788	16384	11325	5058	3940		3704	4588	2294	2294
542783	428	45578		21300	20971	13618	7352	7824		7788	16384	11324	5059	3940		3704	4587	2294	2293
543787	428	45400		21304	20971	13619	7351	7824		7788	16384	11325	5058	3944		3708	4587	2294	2293
544800	428	45975		21304	20971	13621	7349	7823		7788	16384	11327	5056	3943		3708	4587	2294	2293
545801	429	45514		21316	20972	13620	7351	7823		7788	16384	11326	5057	3955		3720	4588	2294	2294
546816	429	45306		21304	20971	13619	7351	7823		7788	16384	11325	5058	3943		3708	4587	2294	2293
547824	430	45526		21304	20971	13619	7351	7823		7788	16384	11325	5058	3943		3708	4587	2294	2293
548838	430	45627		21316	20972	13619	7352	7823		7788	16384	11325	5058	3955		3720	4588	2294	2294
549853	430	45454		21304	20971	13619	7351	7823		7788	16384	11325	5058	3943		3708	4587	2294	2293
550860	431	45399		21308	21004	13635	7368	7823		7788	16384	11325	5058	3947		3712	4620	2310	2310
551874	431	45621		21304	20971	13618	7352	7823		7788	16384	11324	5059	3943		3708	4587	2294	2293
552888	431	45540		21300	20971	13612	7358	7823		7788	16384	11318	5065	3939		3704	4587	2294	2293
553889	432	45355		21316	20972	13603	7368	7823		7788	16384	11309	5074	3955		3720	4588	2294	2294
554900	432	45342		21300	20971	13586	7384	7823		7788	16384	11292	5091	3939		3704	4587	2294	2293
555902	432	45853		21300	20971	13587	7383	7823		7788	16384	11293	5090	3939		3704	4587	2294	2293
556905	433	45531		21008	20972	13587	7384	7551		7516	16384	11293	5090	3935		3700	4588	2294	2294
557906	433	45328		21024	20971	13587	7383	7555		7520	16384	11293	5090	3947		3712	4587	2294	2293
558910	434	45272		20732	20971	13588	7382	7347		7312	16384	11294	5089	3943		3708	4587	2294	2293
559912	435	45584		20728	21003	13604	7398	7343		7308	16384	11294	5089	3943		3708	4619	2310	2309
560917	436	45493		20744	20972	13588	7383	7343		7308	16384	11294	5089	3959		3724	4588	2294	2294
561921	437	45623		20728	20971	13588	7382	7343		7308	16384	11294	5089	3943		3708	4587	2294	2293
562922	438	45560		20720	20971	13588	7382	7343		7308	16384	11294	5089	3935		3700	4587	2294	2293
563925	439	45836		20696	20972	13588	7383	7315		7280	16384	11294	5089	3955		3720	4588	2294	2294
564929	440	45717		20684	20971	13588	7382	7315		7280	16384	11294	5089	3943		3708	4587	2294	2293
565945	441	45657		20684	20971	13588	7382	7315		7280	16384	11294	5089	3943		3708	4587	2294	2293
566948	442	45838		20696	20972	13588	7383	7315		7280	16384	11294	5089	3955		3720	4588	2294	2294
567962	443	45756		20560	20971	13588	7382	7199		7164	16384	11294	5089	3951		3716	4587	2294	2293
568963	444	45562		20552	20971	13588	7382	7199		7164	16384	11294	5089	3943		3708	4587	2294	2293
569979	445	45490		20564	20972	13588	7383	7199		7164	16384	11294	5089	3955		3720	4588	2294	2294
570995	445	45917		20560	20971	13588	7382	7199		7164	16384	11294	5089	3951		3716	4587	2294	2293
572000	446	45654		20560	20971	13588	7382	7199		7164	16384	11294	5089	3951		3716	4587	2294	2293
573001	447	45546		20580	20972	13588	7383	7199		7164	16384	11294	5089	3971		3736	4588	2294	2294
574016	448	45886		20400	20971	13588	7382	7063		7028	16384	11294	5089	3943		3708	4587	2294	2293
575021	449	45723		20404	20971	13588	7382	7063		7028	16384	11294	5089	3947		3712	4587	2294	2293
576024	450	45554		20140	20972	13588	7383	6783		6748	16384	11294	5089	3963		3728	4588	2294	2294
577030	451	45553		19804	20971	13588	7382	6463		6428	16384	11294	5089	3947		3712	4587	2294	2293
578031	452	45818		19796	20971	13588	7382	6459		6424	16384	11294	5089	3943		3708	4587	2294	2293
579032	453	45672		19804	20972	13588	7383	6459		6424	16384	11294	5089	3951		3716	4588	2294	2294
580040	454	45644		19800	21003	13604	7398	6459		6424	16384	11294	5089	3947		3712	4619	2310	2309
581045	455	45930		19804	20971	13588	7382	6459		6424	16384	11294	5089	3951		3716	4587	2294	2293
582046	456	45788		19800	20972	13588	7383	6459		6424	16384	11294	5089	3947		3712	4588	2294	2294
583049	457	45649		19800	20971	13588	7382	6459		6424	16384	11294	5089	3947		3712	4587	2294	2293
584054	458	45592		19772	20971	13588	7382	6459		6424	16384	11294	5089	3939		3704	4587	2294	2293
585068	459	45569		19776	21003	13604	7398	6459		6424	16384	11294	5089	3943		3708	4619	2310	2309
586084	460	45459		19796	20972	13588	7383	6459		6424	16384	11294	5089	3963		3728	4588	2294	2294
587090	461	45385		19776	20971	13588	7382	6459		6424	16384	11294	5089	3943		3708	4587	2294	2293
588103	462	45708		19776	20971	13588	7382	6459		6424	16384	11294	5089	3943		3708	4587	2294	2293
589111	463	45584		19792	20972	13588	7383	6459		6424	16384	11294	5089	3959		3724	4588	2294	2294
590116	464	45373		19772	20971	13588	7382	6459		6424	16384	11294	5089	3939		3704	4587	2294	2293
591119	465	45369		19772	20971	13588	7382	6459		6424	16384	11294	5089	3939		3704	4587	2294	2293
592124	466	45538		19788	20972	13587	7384	6459		6424	16384	11293	5090	3955		3720	4588	2294	2294
593131	467	45529		19776	20971	13588	7382	6459		6424	16384	11294	5089	3943		3708	4587	2294	2293
594137	468	45271		19776	20971	13588	7382	6459		6424	16384	11294	5089	3943		3708	4587	2294	2293
595154	469	45286		19792	20972	13587	7384	6459		6424	16384	11293	5090	3959		3724	4588	2294	2294
596167	470	45562		19776	20971	13588	7382	6459		6424	16384	11294	5089	3943		3708	4587	2294	2293
597181	471	45479		19776	20971	13588	7382	6459		6424	16384	11294	5089	3943		3708	4587	2294	2293
598187	472	45333		19792	20972	13587	7384	6459		6424	16384	11293	5090	3959		3724	4588	2294	2294
599205	473	45795		19780	20971	13579	7391	6459		6424	16384	11285	5098	3947		3712	4587	2294	2293
600221	474	45688		19764	20971	13563	7407	6455		6420	16384	11269	5114	3935		3700	4587	2294	2293
601235	475	45528		19784	20972	13579	7392	6455		6420	16384	11269	5114	3955		3720	4588	2310	2278
602250	476	45506		19772	20971	13563	7407	6455		6420	16384	11269	5114	3943		3708	4587	2294	2293
603250	477	45793		19772	20971	13563	7407	6455		6420	16384	11269	5114	3943		3708	4587	2294	2293
604265	478	45704		19784	20972	13563	7408	6455		6420	16384	11269	5114	3955		3720	4588	2294	2294
605269	479	45600		19776	20971	13564	7406	6455		6420	16384	11270	5113	3947		3712	4587	2294	2293
606284	480	45786		19768	20971	13564	7406	6455		6420	16384	11270	5113	3939		3704	4587	2294	2293
607291	481	45807		19788	20972	13563	7408	6459		6424	16384	11269	5114	3955		3720	4588	2294	2294
608305	482	45612		19776	20971	13564	7406	6459		6424	16384	11270	5113	3943		3708	4587	2294	2293
609320	483	45613		19776	21003	13580	7422	6459		6424	16384	11270	5113	3943		3708	4619	2310	2309
610320	484	45815		19796	20972	13564	7407	6459		6424	16384	11270	5113	3963		3728	4588	2294	2294
611334	484	45695		19780	20971	13564	7406	6459		6424	16384	11270	5113	3947		3712	4587	2294	2293
612339	485	45633		19772	20971	13564	7406	6459		6424	16384	11270	5113	3939		3704	4587	2294	2293
613346	486	45809		19788	20972	13564	7407	6459		6424	16384	11270	5113	3955		3720	4588	2294	2294
614355	487	45768		19772	21003	13580	7422	6459		6424	16384	11270	5113	3939		3704	4619	2310	2309
615357	488	45610		19776	20971	13564	7406	6459		6424	16384	11270	5113	3943		3708	4587	2294	2293
616363	489	45602		19784	20972	13565	7406	6459		6424	16384	11271	5112	3951		3716	4588	2294	2294
617368	490	45889		19776	20971	13564	7406	6459		6424	16384	11270	5113	3943		3708	4587	2294	2293
618382	491	45652		19776	20971	13564	7406	6459		6424	16384	11270	5113	3943		3708	4587	2294	2293
619384	492	45640		19792	20972	13564	7407	6459		6424	16384	11270	5113	3959		3724	4588	2294	2294
620395	493	45918		19780	20971	13580	7390	6459		6424	16384	11270	5113	3947		3712	4587	2310	2277
621411	494	45786		19780	20971	13564	7406	6459		6424	16384	11270	5113	3947		3712	4587	2294	2293
622415	495	45624		19792	20972	13564	7407	6459		6424	16384	11270	5113	3959		3724	4588	2294	2294
623418	496	45906		19772	20971	13564	7406	6459		6424	16384	11270	5113	3939		3704	4587	2294	2293
624431	497	45886		19772	20971	13564	7406	6459		6424	16384	11270	5113	3939		3704	4587	2294	2293
625447	498	45646		19788	20972	13563	7408	6459		6424	16384	11269	5114	3955		3720	4588	2294	2294
626462	499	45624		19776	20971	13564	7406	6459		6424	16384	11270	5113	3943		3708	4587	2294	2293
627474	500	45907		19768	20971	13564	7406	6459		6424	16384	11270	5113	3935		3700	4587	2294	2293
628476	501	45787		19784	20972	13563	7408	6459		6424	16384	11269	5114	3951		3716	4588	2294	2294
629478	502	45695		19772	20971	13564	7406	6459		6424	16384	11270	5113	3939		3704	4587	2294	2293
630483	503	45918		19776	20971	13564	7406	6459		6424	16384	11270	5113	3943		3708	4587	2294	2293
631497	504	45802		19788	20972	13564	7407	6459		6424	16384	11270	5113	3955		3720	4588	2294	2294
632510	505	45666		19780	20971	13564	7406	6459		6424	16384	11270	5113	3947		3712	4587	2294	2293
633517	506	45614		19768	20971	13564	7406	6459		6424	16384	11270	5113	3935		3700	4587	2294	2293
634532	507	45580		19796	20972	13564	7407	6459		6424	16384	11270	5113	3963		3728	4588	2294	2294
635537	508	45420		19780	20971	13564	7406	6459		6424	16384	11270	5113	3947		3712	4587	2294	2293
636540	509	45321		19780	20971	13564	7406	6459		6424	16384	11270	5113	3947		3712	4587	2294	2293
637544	510	45557		19780	20972	13564	7407	6459		6424	16384	11270	5113	3947		3712	4588	2294	2294
638547	511	45489		19780	20971	13564	7406	6459		6424	16384	11270	5113	3947		3712	4587	2294	2293
639549	512	45302		19784	20971	13564	7406	6459		6424	16384	11270	5113	3951		3716	4587	2294	2293
640553	513	45264		19780	20971	13564	7406	6459		6424	16384	11270	5113	3947		3712	4587	2294	2293
641559	514	45540		19796	20972	13564	7407	6459		6424	16384	11270	5113	3963		3728	4588	2294	2294
642575	515	45429		19784	20971	13564	7406	6459		6424	16384	11270	5113	3951		3716	4587	2294	2293
643576	516	45316		19784	20971	13564	7406	6459		6424	16384	11270	5113	3951		3716	4587	2294	2293
644578	517	45575		19784	20972	13565	7406	6459		6424	16384	11271	5112	3951		3716	4588	2294	2294
645580	518	45477		19776	20971	13566	7404	6459		6424	16384	11272	5111	3943		3708	4587	2294	2293
646582	519	45316		19784	20971	13565	7405	6459		6424	16384	11271	5112	3951		3716	4587	2294	2293
647589	520	45526		19796	20972	13565	7406	6459		6424	16384	11271	5112	3963		3728	4588	2294	2294
648592	521	45537		19788	20971	13565	7405	6459		6424	16384	11271	5112	3955		3720	4587	2294	2293
649599	522	45656		19792	20971	13565	7405	6459		6424	16384	11271	5112	3959		3724	4587	2294	2293
650613	523	45550		19792	20972	13565	7406	6459		6424	16384	11271	5112	3959		3724	4588	2294	2294
651617	524	45798		19780	20971	13565	7405	6459		6424	16384	11271	5112	3947		3712	4587	2294	2293
652620	524	45715		19780	20971	13565	7405	6459		6424	16384	11271	5112	3947		3712	4587	2294	2293
653620	525	45647		19796	20972	13565	7406	6459		6424	16384	11271	5112	3963		3728	4588	2294	2294
654631	527	45792		19780	20971	13565	7405	6459		6424	16384	11271	5112	3947		3712	4587	2294	2293
655632	528	45790		19772	20971	13563	7407	6459		6424	16384	11269	5114	3939		3704	4587	2294	2293
656636	528	45575		19788	20972	13565	7406	6459		6424	16384	11271	5112	3955		3720	4588	2294	2294
657639	529	45533		19776	20971	13565	7405	6459		6424	16384	11271	5112	3943		3708	4587	2294	2293
658643	531	45532		19776	20971	13563	7407	6459		6424	16384	11269	5114	3943		3708	4587	2294	2293
659649	532	45809		19792	21004	13581	7422	6459		6424	16384	11271	5112	3959		3724	4620	2310	2310
660664	533	45715		19780	20971	13565	7405	6455		6420	16384	11271	5112	3951		3716	4587	2294	2293
661678	533	45590		19776	20971	13563	7407	6455		6420	16384	11269	5114	3947		3712	4587	2294	2293
662685	534	45593		19788	21004	13581	7422	6455		6420	16384	11271	5112	3959		3724	4620	2310	2310
663700	535	45872		19780	20971	13566	7404	6455		6420	16384	11272	5111	3951		3716	4587	2294	2293
664703	536	45738		19776	20971	13581	7389	6455		6420	16384	11271	5112	3947		3712	4587	2310	2277
665703	537	45557		19788	20972	13566	7405	6455		6420	16384	11272	5111	3959		3724	4588	2294	2294
666713	538	45872		19780	20971	13566	7404	6455		6420	16384	11272	5111	3951		3716	4587	2294	2293
667721	539	45672		19768	20971	13565	7405	6455		6420	16384	11271	5112	3939		3704	4587	2294	2293
668725	540	45508		19784	20972	13566	7405	6455		6420	16384	11272	5111	3955		3720	4588	2294	2294
669733	541	45511		19772	20971	13566	7404	6455		6420	16384	11272	5111	3943		3708	4587	2294	2293
670746	542	45779		19784	20971	13549	7421	6455		6420	16384	11255	5128	3955		3720	4587	2294	2293
671764	543	45683		19792	20972	13550	7421	6455		6420	16384	11256	5127	3963		3728	4588	2294	2294
672775	544	45517		19768	20971	13550	7420	6455		6420	16384	11256	5127	3939		3704	4587	2294	2293
673779	545	45537		19772	20971	13549	7421	6455		6420	16384	11255	5128	3943		3708	4587	2294	2293
674784	546	45878		19792	20972	13550	7421	6455		6420	16384	11256	5127	3963		3728	4588	2294	2294
675786	547	45726		19776	20971	13550	7420	6455		6420	16384	11256	5127	3947		3712	4587	2294	2293
676789	548	45589		19776	20971	13550	7420	6455		6420	16384	11256	5127	3947		3712	4587	2294	2293
677796	549	45561		19776	20972	13550	7421	6455		6420	16384	11256	5127	3947		3712	4588	2294	2294
678801	550	45862		19776	20971	13549	7421	6455		6420	16384	11255	5128	3947		3712	4587	2294	2293
679804	551	45454		19772	20971	13547	7423	6455		6420	16384	11253	5130	3943		3708	4587	2294	2293
680808	552	45335		19780	20972	13545	7426	6455		6420	16384	11251	5132	3951		3716	4588	2294	2294
681811	553	45517		19776	20971	13545	7425	6455		6420	16384	11251	5132	3947		3712	4587	2294	2293
682827	554	45423		19776	20971	13543	7427	6455		6420	16384	11249	5134	3947		3712	4587	2294	2293
683828	555	45612		19780	20972	13545	7426	6455		6420	16384	11251	5132	3951		3716	4588	2294	2294
684833	556	45287		19776	20971	13545	7425	6455		6420	16384	11251	5132	3947		3712	4587	2294	2293
685835	557	45501		19776	20971	13543	7427	6455		6420	16384	11249	5134	3947		3712	4587	2294	2293
686842	558	45257		19776	20971	13545	7425	6455		6420	16384	11251	5132	3947		3712	4587	2294	2293
687856	559	45293		19788	20972	13530	7441	6455		6420	16384	11236	5147	3959		3724	4588	2294	2294
688859	560	45463		19776	20971	13483	7487	6455		6420	16384	11189	5194	3947		3712	4587	2294	2293
689876	561	45531		19768	21003	13443	7559	6455		6420	16384	11133	5250	3939		3704	4619	2310	2309
690877	562	45520		19792	20972	13429	7542	6455		6420	16384	11135	5248	3963		3728	4588	2294	2294
691891	563	45728		19776	20971	13427	7543	6455		6420	16384	11133	5250	3947		3712	4587	2294	2293
692901	564	45733		19776	20971	13427	7543	6455		6420	16384	11133	5250	3947		3712	4587	2294	2293
693917	565	45514		19792	20972	13429	7542	6455		6420	16384	11135	5248	3963		3728	4588	2294	2294
694919	566	45502		19776	20971	13427	7543	6455		6420	16384	11133	5250	3947		3712	4587	2294	2293
695932	567	45732		19776	20971	13427	7543	6455		6420	16384	11133	5250	3947		3712	4587	2294	2293
696934	568	45642		19788	20972	13429	7542	6455		6420	16384	11135	5248	3959		3724	4588	2294	2294
697936	569	45523		19776	20971	13424	7546	6455		6420	16384	11130	5253	3947		3712	4587	2294	2293
698949	570	45504		19776	20971	13420	7550	6455		6420	16384	11126	5257	3947		3712	4587	2294	2293
699955	571	45660		19788	20972	13413	7558	6455		6420	16384	11119	5264	3959		3724	4588	2294	2294
700969	572	45575		19780	20971	13395	7575	6455		6420	16384	11101	5282	3951		3716	4587	2294	2293
701970	573	45518		19776	20971	13395	7575	6455		6420	16384	11101	5282	3947		3712	4587	2294	2293
702974	574	45739		19784	20972	13397	7574	6455		6420	16384	11103	5280	3955		3720	4588	2294	2294
703980	575	45626		19784	20971	13395	7575	6459		6424	16384	11101	5282	3951		3716	4587	2294	2293
704981	576	45568		19784	20971	13395	7575	6459		6424	16384	11101	5282	3951		3716	4587	2294	2293
705993	577	45742		19792	20972	13395	7576	6459		6424	16384	11101	5282	3959		3724	4588	2294	2294
706998	578	45665		19788	20971	13394	7576	6459		6424	16384	11100	5283	3955		3720	4587	2294	2293
708005	579	45490		19780	20971	13394	7576	6459		6424	16384	11100	5283	3947		3712	4587	2294	2293
709004	580	45458		19780	20971	13395	7575	6459		6424	16384	11101	5282	3947		3712	4587	2294	2293
710009	581	45745		19796	20972	13395	7576	6459		6424	16384	11101	5282	3963		3728	4588	2294	2294
711016	582	45597		19784	20971	13394	7576	6459		6424	16384	11100	5283	3951		3716	4587	2294	2293
712029	583	45510		19784	20971	13395	7575	6459		6424	16384	11101	5282	3951		3716	4587	2294	2293
713041	584	45670		19792	20972	13395	7576	6459		6424	16384	11101	5282	3959		3724	4588	2294	2294
714046	584	45632		19780	20971	13394	7576	6459		6424	16384	11100	5283	3947		3712	4587	2294	2293
715051	585	45532		19788	20971	13395	7575	6458		6424	16384	11101	5282	3955		3720	4587	2294	2293
716057	586	45166		19800	20972	13395	7576	6458		6424	16384	11101	5282	3967		3732	4588	2294	2294
717073	586	45706		19796	20972	13394	7577	6462		6428	16384	11100	5283	3957		3724	4588	2294	2294
718075	587	45409		19788	20972	13396	7575	6458		6424	16384	11102	5281	3953		3720	4588	2294	2294
719083	588	45406		19780	20972	13395	7576	6459		6424	16384	11101	5282	3948		3712	4588	2294	2294
720085	589	45401		19792	20972	13410	7561	6459		6424	16384	11100	5283	3960		3724	4588	2310	2278
721100	590	45597		19780	20972	13396	7575	6459		6424	16384	11102	5281	3948		3712	4588	2294	2294
722104	591	45512		19780	20972	13395	7576	6458		6424	16384	11101	5282	3947		3712	4588	2294	2294
723123	592	45333		19792	20972	13394	7577	6458		6424	16384	11100	5283	3959		3724	4588	2294	2294
724127	593	45477		19784	20972	13395	7576	6458		6424	16384	11101	5282	3949		3716	4588	2294	2294
725135	594	45572		19780	20972	13395	7576	6458		6424	16384	11101	5282	3944		3712	4588	2294	2294
726143	594	45720		19780	20972	13394	7577	6458		6424	16384	11100	5283	3945		3712	4588	2294	2294
727148	595	45586		19784	20972	13395	7576	6458		6424	16384	11101	5282	3950		3716	4588	2294	2294
728151	596	45585		19788	20972	13395	7576	6458		6424	16384	11101	5282	3953		3720	4588	2294	2294
729153	597	45761		19784	20972	13394	7577	6458		6424	16384	11100	5283	3949		3716	4588	2294	2294
730170	597	45776		19776	20972	13395	7576	6454		6420	16384	11101	5282	3950		3712	4588	2294	2294
731173	598	45830		19776	20972	13396	7576	6454		6420	16384	11102	5282	3947		3712	4588	2294	2294
732175	598	45401		19776	20972	13396	7576	6454		6420	16384	11102	5282	3949		3712	4588	2294	2294
733177	599	45408		19776	20972	13394	7577	6454		6420	16384	11100	5283	3949		3712	4588	2294	2294
734192	600	45388		19788	20972	13396	7576	6454		6420	16384	11102	5282	3961		3724	4588	2294	2294
735208	601	45582		19776	20972	13396	7576	6454		6420	16384	11102	5282	3949		3712	4588	2294	2294
736223	601	45451		19776	20972	13394	7577	6454		6420	16384	11100	5283	3949		3712	4588	2294	2294
737227	602	45575		19784	20972	13396	7575	6454		6420	16384	11102	5281	3957		3720	4588	2294	2294
738241	603	45507		19780	20972	13396	7575	6454		6420	16384	11102	5281	3953		3716	4588	2294	2294
739243	604	45296		19800	20972	13397	7574	6454		6420	16384	11103	5280	3973		3736	4588	2294	2294
740242	605	45314		19784	20972	13396	7575	6454		6420	16384	11102	5281	3957		3720	4588	2294	2294
741246	606	45548		19780	20972	13412	7559	6454		6420	16384	11102	5281	3953		3716	4588	2310	2278
742255	607	45689		19780	20972	13412	7559	6454		6420	16384	11102	5281	3953		3716	4588	2310	2278
743257	607	45567		19792	20972	13396	7575	6454		6420	16384	11102	5281	3965		3728	4588	2294	2294
744260	608	45610		19784	20972	13396	7575	6454		6420	16384	11102	5281	3957		3720	4588	2294	2294
745263	609	45534		19784	20972	13396	7575	6454		6420	16384	11102	5281	3957		3720	4588	2294	2294
746267	610	45494		19784	20972	13395	7577	6454		6420	16384	11101	5283	3957		3720	4588	2294	2294
747268	611	45416		19792	20972	13396	7575	6454		6420	16384	11102	5281	3965		3728	4588	2294	2294
748271	612	45263		19780	20972	13396	7575	6454		6420	16384	11102	5281	3953		3716	4588	2294	2294
749277	613	45566		19780	20972	13394	7577	6454		6420	16384	11100	5283	3953		3716	4588	2294	2294
750292	614	45704		19792	20972	13412	7559	6454		6420	16384	11102	5281	3965		3728	4588	2310	2278
751297	614	45614		19780	20972	13396	7575	6455		6420	16384	11102	5281	3953		3716	4588	2294	2294
752307	615	45689		19780	20972	13410	7561	6455		6420	16384	11100	5283	3953		3716	4588	2310	2278
753308	616	45685		19780	20972	13395	7576	6455		6420	16384	11101	5282	3954		3716	4588	2294	2294
754323	617	45611		19780	20972	13396	7575	6455		6420	16384	11102	5281	3954		3716	4588	2294	2294
755338	618	45481		19780	20972	13394	7577	6455		6420	16384	11100	5283	3954		3716	4588	2294	2294
756343	619	45476		19784	20972	13396	7575	6455		6420	16384	11102	5281	3958		3720	4588	2294	2294
757349	620	45461		19780	20972	13396	7575	6455		6420	16384	11102	5281	3954		3716	4588	2294	2294
758363	621	46021		19792	20972	13396	7575	6455		6420	16384	11102	5281	3967		3728	4588	2294	2294
759380	622	45876		19780	20972	13396	7575	6455		6420	16384	11102	5281	3955		3716	4588	2294	2294
760385	623	45797		19780	20972	13396	7575	6455		6420	16384	11102	5281	3954		3716	4588	2294	2294
761398	624	45968		19792	20972	13396	7575	6455		6420	16384	11102	5281	3966		3728	4588	2294	2294
762407	625	45960		19780	20972	13396	7575	6455		6420	16384	11102	5281	3954		3716	4588	2294	2294
763420	626	45727		19780	20972	13396	7575	6455		6420	16384	11102	5281	3954		3716	4588	2294	2294
764424	627	46005		19792	20972	13396	7575	6455		6420	16384	11102	5281	3966		3728	4588	2294	2294
765438	628	46200		19784	20972	13396	7575	6455		6420	16384	11102	5281	3958		3720	4588	2294	2294
766443	629	46066		19784	20972	13396	7575	6454		6420	16384	11102	5281	3958		3720	4588	2294	2294
767457	630	45962		19796	20972	13396	7575	6454		6420	16384	11102	5281	3970		3732	4588	2294	2294
768472	630	46025		19784	20972	13396	7575	6454		6420	16384	11102	5281	3958		3720	4588	2294	2294
769485	631	46031		19784	20972	13396	7575	6454		6420	16384	11102	5281	3958		3720	4588	2294	2294
770501	632	46073		19780	20972	13396	7575	6455		6420	16384	11102	5281	3957		3716	4588	2294	2294
771531	633	46068		19780	20972	13396	7575	6455		6420	16384	11102	5281	3957		3716	4588	2294	2294
772532	634	46354		19780	20972	13396	7575	6455		6420	16384	11102	5281	3957		3716	4588	2294	2294
773546	635	45984		19784	20972	13396	7575	6455		6420	16384	11102	5281	3961		3720	4588	2294	2294
774561	636	45741		19776	20972	13396	7575	6455		6420	16384	11102	5281	3953		3712	4588	2294	2294
775563	637	45942		19780	20972	13396	7575	6455		6420	16384	11102	5281	3957		3716	4588	2294	2294
776566	638	45922		19780	20972	13396	7575	6455		6420	16384	11102	5281	3957		3716	4588	2294	2294
777580	639	45634		19784	20972	13396	7575	6455		6420	16384	11102	5281	3961		3720	4588	2294	2294
778581	640	45594		19784	20972	13396	7575	6455		6420	16384	11102	5281	3961		3720	4588	2294	2294
779589	641	46219		19792	20972	13397	7574	6455		6420	16384	11103	5280	3969		3728	4588	2294	2294
780602	642	45966		19792	20972	13396	7575	6454		6420	16384	11102	5281	3967		3728	4588	2294	2294
781607	643	45957		19780	20972	13396	7575	6454		6420	16384	11102	5281	3955		3716	4588	2294	2294
782611	644	46260		19780	20972	13397	7574	6450		6416	16384	11103	5280	3959		3720	4588	2294	2294
783615	644	46357		19788	20972	13396	7575	6450		6416	16384	11102	5281	3965		3728	4588	2294	2294
784619	645	45860		19780	20972	13396	7575	6451		6416	16384	11102	5281	3955		3720	4588	2294	2294
785637	646	46261		19772	20972	13397	7574	6451		6416	16384	11103	5280	3951		3712	4588	2294	2294
786643	646	46480		19780	20972	13395	7576	6452		6416	16384	11101	5282	3960		3720	4588	2294	2294
787657	647	46724		19776	20972	13395	7576	6452		6416	16384	11101	5282	3956		3716	4588	2294	2294
788661	648	46611		19788	20972	13397	7574	6452		6416	16384	11103	5280	3967		3728	4588	2294	2294
789664	648	46502		19776	20972	13395	7576	6452		6416	16384	11101	5282	3955		3716	4588	2294	2294
790672	649	46419		19780	20972	13395	7576	6452		6416	16384	11101	5282	3959		3720	4588	2294	2294
791687	649	46505		19776	20972	13395	7576	6452		6416	16384	11101	5282	3955		3716	4588	2294	2294
792702	650	46868		19788	20972	13396	7575	6452		6416	16384	11102	5281	3967		3728	4588	2294	2294
793705	651	46419		19776	20972	13395	7576	6452		6416	16384	11101	5282	3955		3716	4588	2294	2294
794710	652	46222		19776	20972	13395	7576	6452		6416	16384	11101	5282	3955		3716	4588	2294	2294
795711	653	46453		19788	20972	13396	7575	6452		6416	16384	11102	5281	3967		3728	4588	2294	2294
796727	654	46705		19776	20972	13395	7576	6452		6416	16384	11101	5282	3955		3716	4588	2294	2294
797743	655	46626		19788	20972	13395	7576	6452		6416	16384	11101	5282	3967		3728	4588	2294	2294
798746	656	46433		19800	20972	13412	7559	6452		6416	16384	11102	5281	3979		3740	4588	2310	2278
799760	657	46387		19784	20972	13397	7574	6452		6416	16384	11103	5280	3963		3724	4588	2294	2294
800764	657	46726		19784	20972	13397	7574	6452		6416	16384	11103	5280	3963		3724	4588	2294	2294
801767	658	46473		19796	20972	13396	7575	6451		6416	16384	11102	5281	3974		3736	4588	2294	2294
802778	659	46110		19784	20972	13397	7574	6451		6416	16384	11103	5280	3962		3724	4588	2294	2294
803783	660	46360		19776	20972	13397	7574	6451		6416	16384	11103	5280	3952		3716	4588	2294	2294
804785	661	46535		19776	20972	13396	7575	6451		6416	16384	11102	5281	3952		3716	4588	2294	2294
805795	662	46435		19792	20972	13395	7576	6451		6416	16384	11101	5282	3968		3732	4588	2294	2294
806799	663	46624		19780	20972	13395	7576	6451		6416	16384	11101	5282	3956		3720	4588	2294	2294
807808	663	46427		19780	20972	13395	7576	6451		6416	16384	11101	5282	3956		3720	4588	2294	2294
808824	664	46325		19788	20972	13395	7576	6451		6416	16384	11101	5282	3964		3728	4588	2294	2294
809825	665	46300		19784	20972	13395	7576	6451		6416	16384	11101	5282	3960		3724	4588	2294	2294
810828	666	46559		19784	20972	13395	7576	6451		6416	16384	11101	5282	3960		3724	4588	2294	2294
811829	667	46428		19796	20972	13394	7577	6451		6416	16384	11100	5283	3972		3736	4588	2294	2294
812845	668	46022		19788	21004	13412	7591	6451		6416	16384	11102	5281	3964		3728	4620	2310	2310
813856	669	46044		19776	20972	13397	7574	6451		6416	16384	11103	5280	3952		3716	4588	2294	2294
814857	670	46554		19788	20972	13395	7576	6451		6416	16384	11101	5282	3964		3728	4588	2294	2294
815874	671	46399		19776	20972	13396	7575	6451		6416	16384	11102	5281	3952		3716	4588	2294	2294
816876	672	46221		19780	20972	13397	7574	6451		6416	16384	11103	5280	3956		3720	4588	2294	2294
817880	673	46222		19792	20972	13395	7576	6451		6416	16384	11101	5282	3968		3732	4588	2294	2294
818883	674	46469		19740	20972	13396	7575	6427		6392	16384	11102	5281	3938		3704	4588	2294	2294
819897	675	46273		19736	20972	13397	7574	6427		6392	16384	11103	5280	3936		3700	4588	2294	2294
820898	676	46169		19744	20972	13395	7576	6427		6392	16384	11101	5282	3944		3708	4588	2294	2294
821913	677	46475		19744	20972	13396	7575	6427		6392	16384	11102	5281	3944		3708	4588	2294	2294
822927	678	46102		19744	20972	13397	7574	6427		6392	16384	11103	5280	3944		3708	4588	2294	2294
823929	679	45749		19744	20972	13411	7560	6426		6392	16384	11101	5282	3944		3708	4588	2310	2278
824933	680	45737		19744	20972	13396	7575	6426		6392	16384	11102	5281	3944		3708	4588	2294	2294
825934	681	46017		19736	20972	13397	7574	6426		6392	16384	11103	5280	3936		3700	4588	2294	2294
826941	682	45934		19740	20972	13395	7576	6426		6392	16384	11101	5282	3940		3704	4588	2294	2294
827945	683	45731		19744	20972	13397	7574	6426		6392	16384	11103	5280	3944		3708	4588	2294	2294
828959	684	46012		19756	20972	13397	7574	6426		6392	16384	11103	5280	3956		3720	4588	2294	2294
829963	685	46124		19744	20972	13395	7576	6426		6392	16384	11101	5282	3943		3708	4588	2294	2294
830968	686	46063		19736	20972	13397	7574	6426		6392	16384	11103	5280	3935		3700	4588	2294	2294
831984	687	46010		19740	20972	13397	7574	6426		6392	16384	11103	5280	3939		3704	4588	2294	2294
832987	687	46420		19760	20972	13396	7575	6426		6392	16384	11102	5281	3959		3724	4588	2294	2294
833991	688	46047		19744	20972	13396	7575	6427		6392	16384	11102	5281	3948		3708	4588	2294	2294
834994	689	46002		19744	20972	13397	7574	6427		6392	16384	11103	5280	3948		3708	4588	2294	2294
836007	690	46102		19744	20972	13396	7575	6427		6392	16384	11102	5281	3948		3708	4588	2294	2294
837016	691	46142		19748	20972	13395	7576	6427		6392	16384	11101	5282	3952		3712	4588	2294	2294
838020	692	45886		19736	20972	13397	7574	6427		6392	16384	11103	5280	3940		3700	4588	2294	2294
839025	693	46125		19736	20972	13396	7575	6427		6392	16384	11102	5281	3940		3700	4588	2294	2294
840038	694	46111		19752	20972	13395	7576	6426		6392	16384	11101	5282	3955		3716	4588	2294	2294
841045	695	46374		19736	20972	13397	7574	6426		6392	16384	11103	5280	3939		3700	4588	2294	2294
842051	696	46456		19736	20972	13396	7575	6427		6392	16384	11102	5281	3948		3700	4588	2294	2294
843052	696	46429		19748	21004	13411	7592	6427		6392	16384	11101	5282	3962		3712	4620	2310	2310
844061	697	46366		19744	20972	13397	7574	6427		6392	16384	11103	5280	3956		3708	4588	2294	2294
845077	698	46004		19740	20972	13397	7574	6427		6392	16384	11103	5280	3952		3704	4588	2294	2294
846082	699	46333		19760	20972	13397	7574	6427		6392	16384	11103	5280	3972		3724	4588	2294	2294
847093	700	46142		19744	20972	13397	7574	6431		6396	16384	11103	5280	3950		3704	4588	2294	2294
848093	701	46618		19744	20972	13397	7574	6432		6396	16384	11103	5280	3946		3704	4588	2294	2294
849106	701	46724		19744	21004	13412	7591	6434		6396	16384	11102	5281	3946		3704	4620	2310	2310
850107	702	47165		19760	20972	13397	7574	6434		6396	16384	11103	5280	3962		3720	4588	2294	2294
851109	703	46594		19740	20972	13397	7574	6434		6396	16384	11103	5280	3942		3700	4588	2294	2294
852123	704	46454		19744	20972	13396	7575	6434		6396	16384	11102	5281	3946		3704	4588	2294	2294
853136	705	46689		19740	20972	13397	7574	6434		6396	16384	11103	5280	3942		3700	4588	2294	2294
854140	706	46697		19752	20973	13398	7574	6434		6396	16384	11103	5280	3954		3712	4589	2295	2294
855142	707	46685		19740	20972	13396	7575	6434		6396	16384	11102	5281	3942		3700	4588	2294	2294
856156	707	46517		19752	20972	13397	7574	6434		6396	16384	11103	5280	3954		3712	4588	2294	2294
857157	708	46908		19764	20973	13398	7574	6434		6396	16384	11103	5280	3966		3724	4589	2295	2294
858172	709	46725		19740	20972	13396	7575	6434		6396	16384	11102	5281	3942		3700	4588	2294	2294
859185	710	46408		19744	20972	13397	7574	6430		6392	16384	11103	5280	3956		3708	4588	2294	2294
860201	711	46414		19756	20973	13398	7574	6430		6392	16384	11103	5280	3968		3720	4589	2295	2294
861207	712	46326		19744	20972	13395	7576	6430		6392	16384	11101	5282	3956		3708	4588	2294	2294
862212	713	46911		19748	20972	13396	7575	6430		6392	16384	11102	5281	3960		3712	4588	2294	2294
863221	714	46758		19760	20973	13398	7574	6430		6392	16384	11103	5280	3972		3724	4589	2295	2294
864223	715	46600		19744	20972	13395	7576	6430		6392	16384	11101	5282	3956		3708	4588	2294	2294
865225	715	46857		19744	20972	13396	7575	6430		6392	16384	11102	5281	3956		3708	4588	2294	2294
866228	717	46663		19744	20972	13396	7575	6428		6392	16384	11102	5281	3956		3708	4588	2294	2294
867230	717	46767		19760	20973	13398	7574	6430		6392	16384	11103	5280	3975		3724	4589	2295	2294
868244	718	46690		19744	20972	13396	7575	6430		6392	16384	11102	5281	3959		3708	4588	2294	2294
869259	719	47080		19736	20972	13396	7575	6430		6392	16384	11102	5281	3951		3700	4588	2294	2294
870269	720	46857		19752	20973	13398	7574	6430		6392	16384	11103	5280	3967		3716	4589	2295	2294
871285	721	46390		19740	20972	13396	7575	6430		6392	16384	11102	5281	3955		3704	4588	2294	2294
872285	722	46739		19744	20972	13396	7575	6430		6392	16384	11102	5281	3961		3708	4588	2294	2294
873291	723	46709		19740	20972	13396	7575	6430		6392	16384	11102	5281	3958		3704	4588	2294	2294
874296	724	46396		19752	20973	13397	7575	6430		6392	16384	11102	5281	3970		3716	4589	2295	2294
875298	725	46639		19740	20972	13396	7575	6430		6392	16384	11102	5281	3958		3704	4588	2294	2294
876314	726	46958		19740	20972	13396	7575	6430		6392	16384	11102	5281	3958		3704	4588	2294	2294
877322	727	46933		19740	20972	13396	7575	6430		6392	16384	11102	5281	3958		3704	4588	2294	2294
878334	727	46604		19752	20973	13397	7575	6430		6392	16384	11102	5281	3970		3716	4589	2295	2294
879336	728	46546		19740	20972	13396	7575	6430		6392	16384	11102	5281	3958		3704	4588	2294	2294
880348	729	46931		19740	21004	13412	7591	6430		6392	16384	11102	5281	3958		3704	4620	2310	2310
881357	730	46720		19748	20973	13397	7575	6418		6380	16384	11102	5281	3978		3724	4589	2295	2294
882370	731	46432		19732	20972	13397	7574	6418		6380	16384	11103	5280	3962		3708	4588	2294	2294
883373	732	46429		19728	20972	13397	7574	6418		6380	16384	11103	5280	3958		3704	4588	2294	2294
884388	733	46568		19744	20973	13398	7574	6416		6380	16384	11103	5280	3971		3720	4589	2295	2294
885391	733	47139		19736	20972	13396	7575	6418		6380	16384	11102	5281	3965		3712	4588	2294	2294
886395	734	46944		19728	20972	13396	7575	6418		6380	16384	11102	5281	3958		3704	4588	2294	2294
887399	735	46570		19732	20973	13397	7575	6418		6380	16384	11102	5281	3962		3708	4589	2295	2294
888404	736	46371		19736	20972	13397	7574	6418		6380	16384	11103	5280	3966		3712	4588	2294	2294
889409	737	46683		19736	20972	13396	7575	6416		6380	16384	11102	5281	3965		3712	4588	2294	2294
890414	738	46547		19744	20973	13397	7575	6416		6380	16384	11102	5281	3973		3720	4589	2295	2294
891419	739	46398		19728	20972	13397	7574	6416		6380	16384	11103	5280	3958		3704	4588	2294	2294
892430	740	46877		19728	20972	13396	7575	6416		6380	16384	11102	5281	3958		3704	4588	2294	2294
893431	740	47019		19732	20972	13396	7575	6416		6380	16384	11102	5281	3961		3708	4588	2294	2294
894445	741	46489		19744	20973	13397	7575	6416		6380	16384	11102	5281	3973		3720	4589	2295	2294
895451	742	46067		19732	20972	13396	7575	6416		6380	16384	11102	5281	3961		3708	4588	2294	2294
896455	743	46421		19728	20972	13396	7575	6412		6376	16384	11102	5281	3961		3708	4588	2294	2294
897473	744	46316		19728	20972	13396	7575	6412		6376	16384	11102	5281	3959		3708	4588	2294	2294
898475	745	46464		19748	20973	13398	7574	6412		6376	16384	11103	5280	3982		3728	4589	2295	2294
899479	745	46507		19728	20972	13396	7575	6412		6376	16384	11102	5281	3962		3708	4588	2294	2294
900494	746	46527		19728	20972	13397	7574	6412		6376	16384	11103	5280	3962		3708	4588	2294	2294
901494	747	46527		19740	20973	13398	7574	6412		6376	16384	11103	5280	3974		3720	4589	2295	2294
902509	748	46512		19724	20972	13396	7575	6412		6376	16384	11102	5281	3958		3704	4588	2294	2294
903514	749	46966		19732	20973	13398	7574	6414		6376	16384	11103	5280	3970		3716	4589	2295	2294
904527	750	46960		19720	20972	13396	7575	6414		6376	16384	11102	5281	3958		3704	4588	2294	2294
905529	751	46960		19720	20972	13396	7575	6414		6376	16384	11102	5281	3958		3704	4588	2294	2294
906531	752	46969		19736	20973	13398	7574	6414		6376	16384	11103	5280	3974		3720	4589	2295	2294
907535	753	46277		19720	20972	13396	7575	6412		6376	16384	11102	5281	3956		3704	4588	2294	2294
908538	754	46099		19720	20972	13396	7575	6412		6376	16384	11102	5281	3956		3704	4588	2294	2294
909561	755	46427		19732	20973	13398	7574	6412		6376	16384	11103	5280	3968		3716	4589	2295	2294
910579	756	46762		19724	20972	13396	7575	6412		6376	16384	11102	5281	3957		3708	4588	2294	2294
911592	756	46333		19720	20972	13412	7559	6412		6376	16384	11102	5281	3949		3704	4588	2310	2278
912594	757	46554		19724	20972	13397	7574	6412		6376	16384	11103	5280	3953		3708	4588	2294	2294
913596	757	46836		19724	20972	13397	7574	6412		6376	16384	11103	5280	3954		3708	4588	2294	2294
914601	758	46455		19732	20973	13398	7574	6412		6376	16384	11103	5280	3964		3716	4589	2295	2294
915610	759	46261		19720	20972	13398	7573	6412		6376	16384	11104	5279	3952		3704	4588	2294	2294
916627	760	46371		19720	20972	13397	7574	6412		6376	16384	11103	5280	3952		3704	4588	2294	2294
917634	761	46387		19732	20973	13398	7574	6412		6376	16384	11103	5280	3964		3716	4589	2295	2294
918640	761	46376		19720	20972	13398	7573	6412		6376	16384	11104	5279	3952		3704	4588	2294	2294
919642	762	46381		19720	20972	13397	7574	6412		6376	16384	11103	5280	3952		3704	4588	2294	2294
920645	763	46462		19732	20973	13399	7573	6412		6376	16384	11104	5279	3964		3716	4589	2295	2294
921647	764	46807		19720	20972	13398	7573	6412		6376	16384	11104	5279	3952		3704	4588	2294	2294
922663	765	46627		19720	20972	13398	7573	6412		6376	16384	11104	5279	3952		3704	4588	2294	2294
923677	766	46811		19732	20973	13415	7557	6412		6376	16384	11104	5279	3964		3716	4589	2311	2278
924678	767	46417		19728	20972	13398	7573	6412		6376	16384	11104	5279	3960		3712	4588	2294	2294
925680	768	46060		19732	21004	13413	7590	6411		6376	16384	11103	5280	3963		3716	4620	2310	2310
926696	769	46017		19752	20973	13398	7574	6414		6380	16384	11103	5280	3976		3732	4589	2295	2294
927707	770	46459		19736	20972	13398	7573	6415		6380	16384	11104	5279	3961		3716	4588	2294	2294
928723	770	46555		19736	20972	13413	7558	6415		6380	16384	11103	5280	3963		3716	4588	2310	2278
929740	771	46038		19740	20972	13397	7574	6415		6380	16384	11103	5280	3967		3720	4588	2294	2294
930749	772	46018		19732	20972	13399	7572	6415		6380	16384	11105	5278	3959		3712	4588	2294	2294
931764	773	46461		19748	20973	13400	7572	6415		6380	16384	11105	5278	3975		3728	4589	2295	2294
932780	774	46216		19732	20972	13398	7573	6415		6380	16384	11104	5279	3959		3712	4588	2294	2294
933794	775	46251		19732	20972	13398	7573	6415		6380	16384	11104	5279	3959		3712	4588	2294	2294
934796	776	46557		19744	21003	13415	7587	6415		6380	16384	11105	5278	3971		3724	4619	2310	2309
935807	776	46326		19736	20972	13398	7573	6415		6380	16384	11104	5279	3963		3716	4588	2294	2294
936823	777	0	0	0	0	0	0	0	0	0	0	0	0	0	0	0	0	0	0